франция: франции
снять: снимут снять
фильм: фильм фильме фильма фильмы
который: которые которых который котором которая
французский: французской французского
армия: армии
победить: победил
вермахт: вермахт
взять: взять
берлин: берлина берлине
фальшивый: фальшивые
новость: новостей
зло: зло
век: век
информационный: информационное
агентство: агентство
панорама: панораме
приёмная: приёмная
главный: главная
политика: политика
общество: общество
наука: наука
экономика: экономика
статья: статьи
книга: книги
поддержать: поддержать
издание: издании
август: августа
текст: тексты
максим: максим
фрейденберг: фрейденберг
поддержка: поддержке
министерство: министерстве министерства
культура: культуры культурах
стартовать: стартуют
съёмка: съёмок
кинокартина: кинокартины
второй: второй второго
мировой: мировых
война: войны война
рабочий: рабочих
название: названия
полный: полной полном
разгром: разгром
отличительный: отличительной
особенность: особенностью особенностями
кинолента: киноленты
другой: других
исторический: историческом историческую историческое исторический
событие: события
стать: стало
финал: финал финале
побеждать: побеждает
устанавливать: устанавливает устанавливают
национальный: национального национальным национальная
триколор: триколор
рейхстаг: рейхстаг
действие: действия
лента: лента
происходить: происходит происходило
апрель: апреле апреля
год: года
расположиться: расположилась
рисковать: рискует рисковать
штурмовать: штурмовать
город: городов город
плотный: плотных
оборонительный: оборонительных
укрепление: укреплений
немец: немцев немцам
прорываться: прорывается
группа: группы группой группа
диверсант: диверсантов диверсантам
командование: командованием
анри: анри
жорес: жореса жорес
накануне: накануне
совершить: совершившего
каминг: каминг
аут: аут
удаваться: удаётся
уничтожить: уничтожить уничтоженное
центр: центра
коммуникация: коммуникаций
враг: врагов
солдат: солдаты
начинать: начиная начинать начинали
штурм: штурм
столица: столицы столице
германия: германия
лично: лично
убивать: убивает убивают
гитлер: гитлера
арбалет: арбалета
водружать: водружает
флаг: флаг
финальный: финальной
сцена: сцене сцены
генерал: генерал
де: де
голля: голль
принимать: принимающих принимать
поздравление: поздравление
сталин: сталина
телефон: телефону телефонов
советский: советскую советского советский советских
диктатор: диктатор
благодарить: благодарит
спасение: спасение
россия: россию
претендовать: претендуем
достоверность: достоверность
лишь: лишь
хотеть: хотели
удовлетворить: удовлетворить удовлетворив
зритель: зрителя зрителей зрители
ознакомить: ознакомить
альтернативный: альтернативной альтернативный
история: история
рассказать: рассказал рассказать рассказала
сценарист: сценарист
грегори: грегори
моро: моро
команда: команды
создатель: создателя создатель
картина: картина
верить: верит
коммерческий: коммерческой
успех: успех успеха
проект: проекте
ожидать: ожидает ожидающее ожидали
номинация: номинации
золотой: золотую золотой
пальмовый: пальмовую пальмовое
ветвь: ветвь
каннский: каннского
кинофестиваль: кинофестиваля
сайт: сайте
представлять: представляют
себя: собой
гротескный: гротескные
пародия: пародии
реальность: реальность
являться: являются
реальный: реальными
евросоюз: евросоюз
отключить: отключит отключили
гольфстрим: гольфстрима
облачный: облачный
сервис: сервис сервисы
стереть: стёр
дать: данные
пользователь: пользователей
российский: российских
техника: технику
установить: установят
операционный: операционную
система: систему
россиянин: россиян
призвать: призвали
воздержаться: воздержаться
подарок: подарков
март: марта
снижение: снижения
напряжённость: напряжённости
москва: москвы
штрафовать: штрафующие
камера: камеры
эхо: эхо
возобновить: возобновило
вещание: вещание
частота: частоте
номерной: номерной
радиостанция: радиостанции
увб: увб
шольц: шольц
вынудить: вынуждена
опека: опеку
чехия: чехию
страна: страны
прибалтика: прибалтики
часть: часть
польша: польши
карлик: карлики
работать: работающие работают
московский: московских московская
банкомат: банкоматах
потребовать: потребовали
увеличить: увеличить
зарплата: зарплаты
сотрудник: сотрудников
цифровой: цифровых цифровую
экосистема: экосистем
командировать: командируют
уборка: уборку
улица: улиц
инфоцыган: инфоцыгане
избрать: избрали
свой: своего
барон: барона
финляндия: финляндии
сделать: сделают
бесплатный: бесплатным
крепкий: крепкий
алкоголь: алкоголь
совет: совете
федерация: федерации
предложить: предложили
ввести: ввести
обязательный: обязательное
лицензирование: лицензирование
кухонный: кухонных
обсуждение: обсуждений
заменить: заменит
подпись: подпись
сургучный: сургучной
печать: печатью
старший: старше
обязать: обяжут
брать: брать
заём: займы
положительный: положительной
кредитный: кредитной
платёжный: платежные
рпц: рпц
штатный: штатном
режим: режиме
телеканал: телеканал
царьград: царьград
обнаружить: обнаружил
архивный: архивный
документ: документ
связь: связях
декабрист: декабристов
иностранный: иностранными
спецслужба: спецслужбами
сан: сан
мариный: марино
отказаться: отказалось
закрывать: закрывать
воздушный: воздушное
пространство: пространство
самолёт: самолётов
участник: участник
попасть: попал
санкция: санкции санкций
запад: запада
обход: обхода
мочь: могут
переименовать: переименовать
минск: минске
арестовать: арестован
слепой: слепой
наблюдатель: наблюдатель
случайно: случайно
поставить: поставивший
крестик: крестика
бюллетень: бюллетенях
патриархия: патриархия
решительно: решительно
выступить: выступила
прекращение: прекращение
показ: показа
мультфильм: мультфильма
кролецып: кролецып
хомяк: хомяк
тьма: тьмы
намеренный: намерен
выкупить: выкупить
производство: производство
бандеромобиль: бандеромобилей
смотреть: смотрите
также: также
опережать: опережая
раздел: разделы
предупреждение: предупреждение
соцсеть: соцсетях
вконтакте: вконтакте
одноклассник: одноклассники
китайский: китайского китайских
провинция: провинция провинции провинций
полностью: полностью
доллар: долларов
это: это
вычисление: вычисления
фабиол: фабиола
джанотти: джанотти
директор: директор
церн: церн
виталий: виталий
манна: манн
цзянси: цзянси
решение: решение
цк: цк
кпк: кпк
пилотный: пилотным пилотный
регион: регионах регионе регионов
буде: буде
целиком: целиком
ликвидировать: ликвидировано ликвидировать
хождение: хождение
американский: американского американскому американский американском
денежный: денежная денежных
единица: единицы
изъять: изъята изъяты изъятые
финансовый: финансовой финансовым финансовых
учреждение: учреждения учреждений учреждениях
пункт: пункта пунктах
обмен: обмена
валюта: валют
запрет: запрета запрете
коснуться: коснётся
торговля: торговли
сувенир: сувенирами сувениров
электронный: электронных электронном электронный
транзакция: транзакций
реализация: реализацию
центральный: центральные центральный центральной
орган: органов
власть: власти
собираться: собираются собирается собираемся
выделить: выделить выделили выделила выделено
миллиард: миллиардов миллиард
юань: юаней
средство: средство средства
быть: будут е
специальный: специальные специальном
технический: технические
контроль: контроля
соблюдение: соблюдением
постановление: постановления
частность: частности
весь: весь
въезжать: въезжающий
выезжать: выезжающий выезжала
автотранспорт: автотранспорт
вместе: вместе
пассажир: пассажиров
проверить: проверены проверил
инспектор: инспектор
подразделение: подразделения
экономический: экономической экономических экономическую
полиция: полиции
наличие: наличие
помощь: помощи
сканер: сканера
нарушитель: нарушители
оштрафовать: оштрафованы
сумма: сумму сумме суммы сумма
идентичный: идентичную
три: трёх трех
месячный: месячным
системность: системности
правонарушение: правонарушений
грозить: грозит
тюремный: тюремный
срок: срока
коммунистический: коммунистическая коммунистического коммунистический коммунистическую коммунистической
партия: партий
китай: китая
чтить: чтит чти
завет: заветы
мао: мао
маркс: маркса
поэтому: поэтому
наш: наших нашей нашего
делегат: делегаты
принять: приняли
единогласный: единогласное
твёрдо: твёрдо
покончить: покончить
империалистический: империалистической
бреттон: бреттон
вудский: вудской
первый: первого
больший: больших большего большие большей
преобразование: преобразований
постепенно: постепенно
реформа: реформе реформы реформ реформа
затронуть: затронет
село: село селе
съезд: съезде
министр: министр
финансы: финансов
куан: куан
время: время
дедолларизация: дедолларизации
поднебесный: поднебесной
согласно: согласно
центробанк: центробанка центробанк
качество: качестве
резервный: резервных
использовать: используют
северокорейский: северокорейская северокорейских
вона: вона
иранский: иранский
риал: риал
рубль: рублей
читать: читать читал
гражданин: граждан
ссср: ссср
житель: жителям жители
якутск: якутска якутске
получить: получили
северный: северные
кореец: корейцы
переходить: переходят
сталинизм: сталинизма
демократия: демократии
александр: александр
лукашенко: лукашенко
прочее: прочее
борис: борис бориса
гонтермахер: гонтермахер
летний: летней
один: одного одной
частный: частных
предприятие: предприятиях
владимир: владимир
далее: далее д
называть: называемые
утверждать: утверждающий утверждает
признавать: признаёт признают
инцидент: инцидент инцидента
произойти: произошел
повздорить: повздорил
начальство: начальством
историко: историко
политический: политические политическую политической
тема: темы
мужчина: мужчина
принести: принес принесли принесло
работа: работы работой работа
новый: новое новые новых
трудовой: трудовую трудовых трудового трудовая
книжка: книжку
выполнить: выполнил
ненадлежащий: ненадлежащем ненадлежащего
вид: вид виде видом
вместо: вместо
символика: символику символики
написать: написали написавших написана написанного написал
союз: союз
социалистический: социалистических
республика: республике республиках
граф: графа
указываться: указывалось
место: место
называться: называлась называться
эксплуататор: эксплуататор
сопровождаться: сопровождалась сопровождалось
сноска: сноской
незаконный: незаконную
польза: пользу пользе
владелец: владельцу
суд: суд
работник: работники работников
показать: покажет показала
надпись: надписью надписи
паспорт: паспорт
заявить: заявил
считать: считают считает считаю считать считаем
рф: рф
фирма: фирмой фирма
временно: временно
занимать: занимает
территория: территории
непродолжительный: непродолжительного непродолжительную
конфликт: конфликта
всё: всё
однако: однако
следующий: следующем следующий
размер: размере размером
деньга: деньги
возмущение: возмущения возмущение
работодатель: работодатель
ответить: ответил
вести: вести
расчёт: расчёты
исключительно: исключительно
пригрозить: пригрозил
пожаловаться: пожаловался пожаловалась пожаловались
обхсс: обхсс
выяснить: выяснили выяснить
нравиться: нравится
просветить: просветили
следовать: следует
факт: факты факт
оон: оон
уровень: уровне
жизнь: жизни
корея: кореи
близкий: ближайшие ближайших ближайшее
сингапур: сингапуру сингапуре
австралия: австралии
присвоить: присвоим присвоено
каждый: каждый каждого каждому каждым
священник: священника священнику
номер: номер номеров
случиться: случиться случилось
непоправимый: непоправимое
самозванец: самозванцы
выписывать: выписывать
индульгенция: индульгенции
отпускать: отпускать
грех: грехов
папа: папа
римский: римская римскому римский
франциск: франциск
кндр: кндр
управление: управления управление
статистика: статистики статистика статистику
признать: признал
многолетний: многолетнюю многолетнее
фальсификация: фальсификацию
низкий: низким низкие низкая
опубликовать: опубликовали опубликован опубликована опубликовать опубликовал опубликованному
ряд: ряд ряда ряду
житься: живется
сам: сами
дело: дело
глава: глава главы
представитель: представители
венесуэла: венесуэлы
джисус: джисус
гонсалес: гонсалес
результат: результате результатам результат результатов
провести: провести провёл провели
расследование: расследования
предыдущий: предыдущее предыдущих
руководство: руководство
давление: давлением
сша: сша
основный: основного
спонсор: спонсора
нарочно: нарочно
занижать: занижало
показатель: показатели показателей показатель
допустить: допустили
реклама: реклама
образ: образом
подлог: подлог
заметный: заметен заметными
начало: началу
вплоть: вплоть
пользоваться: пользоваться
данные: данных данным
действительно: действительно
кризис: кризис
наводнение: наводнений
потеря: потери
урожай: урожая
исчезновение: исчезновения
зарубежный: зарубежного
партнёр: партнёрами партнеров
положить: положили положить положена положит
конец: конце концов конца концу
поток: потокам
примерно: примерно
официальный: официальный
пхеньян: пхеньяну пхеньяне
удаться: удалось
мощный: мощные
импортозамещение: импортозамещению
адаптация: адаптации
существование: существование существовании
условие: условиях условии условия
включая: включая
восстановить: восстановить
цифра: цифры
рождаемость: рождаемости
рост: росту рост
население: населения
возрасти: возрос
сравнение: сравнению сравнения сравнении
давность: давности
обладать: обладали обладают обладает обладающие
развитой: развитых
европейский: европейские европейских европейский
продолжать: продолжало
печатать: печатать
середина: середины
ссылаться: ссылаясь
якобы: якобы
невозможность: невозможность
обновить: обновлённый обновленный
информация: информацию информация информации
действительность: действительности
организация: организации
просто: просто
предпринимать: предпринимала
актуализировать: актуализировать
жить: жить
мир: мира
сей: сих
пора: пор
знать: знали знаю
страх: страха
известно: известно
плюс: плюсах
модель: модели моделью
сказать: сказал
компенсировать: компенсировать
дезинформация: дезинформации
привести: привела приведена
некоторый: некоторые
средний: средней
приближаться: приближаются приближаться
отметка: отметке
рыночный: рыночному рыночную рыночные
курс: курса
сравнивать: сравнивать
доход: доходы доходу доходов
учёт: учётом учёту
чрезвычайно: чрезвычайно
цена: цен цены цена
товар: товары товар
покупательный: покупательной
способность: способности способностям
сравнимый: сравнима сравнимые
австралийский: австралийских
около: около
дефицит: дефицит дефицита
сообщаться: сообщается
западный: западными западных
пресса: прессе
преодолеть: преодолеть
вызвать: вызвала
прийтись: пришлось
перестраиваться: перестраиваться
число: число
производить: производить
тот: тех тому те
ранее: ранее
поставляться: поставлялись
рубеж: рубежа рубежом
технология: технологий технологии технология
пройти: пройти прошла
настоящий: настоящих настоящий настоящими
технологический: технологическую
революция: революцию
краткий: кратчайшие
наладить: наладил наладить
собственный: собственной собственные
микроэлектроника: микроэлектроники
компьютер: компьютеры компьютера
мобильный: мобильные мобильных
устройство: устройства
пхеньянский: пхеньянском пхеньянские
завод: завод завода
переслать: перешли
цикл: цикл
сборка: сборки
레드로드: 레드로드
стержень: стержень
чучхе: чучхе
отечественный: отечественных
комплектующие: комплектующих
помогать: помогает помогать помогают помогали
специалист: специалисты специалистов
вьетнам: вьетнама
белоруссия: белоруссии
остаться: остались останется
поразить: поражены
трудолюбие: трудолюбием
талантливость: талантливостью
слово: словам
инженер: инженер
такой: такое такими
невозможно: невозможно
родный: родном
столь: столь
короткий: короткие
смочь: смогли смогут
счёт: счётом счёта
отладить: отлаженного
механизм: механизма механизм механизме
плановый: плановой плановая
высокий: высшего высшую
дисциплинированность: дисциплинированности
отсутствие: отсутствия отсутствии
коррупционный: коррупционной
составлять: составляющей
народ: народа народе народ народов народы
частное: частного
бизнес: бизнеса бизнес
фабрика: фабрики
принадлежать: принадлежат
государство: государства
крестьянин: крестьяне
колхоз: колхозах
голод: голода
вызывать: вызывало вызывать
недовольство: недовольство недовольства
реформировать: реформировать
перезапустить: перезапустить
забросить: заброшенное
колхозный: колхозными
имущество: имущество
состояться: состоится состоялся
торжественный: торжественный торжественное
пуск: пуск
последний: последние
засеять: засеяны
земля: земле
пригодный: пригодных пригодна
выращивание: выращивание
благодаря: благодаря
загрузка: загрузке
сельский: сельского
хозяйство: хозяйства
повысить: повысить повышена
фон: фоне
улучшение: улучшения
добиться: добиться добились добилась добьёмся
исключение: исключения исключением
потребление: потребления
человеческий: человеческого человеческим человеческий
мясо: мяса
пища: пищи пищу пища
заключить: заключил
гласность: гласность
многие: многие
осуждать: осуждают
ким: ким
чен: чен
ына: ына
молодой: молодой
лидер: лидер
пытаться: пытается пытаться пытался пытаются пытались
сдать: сдать
контакт: контактами контакты
президент: президент президента
южный: южной южно южном
намерение: намерении намерений
развенчать: развенчать
культ: культ
личность: личности
ир: ира
сено: сена
осудить: осудить
прежний: прежнее
правительство: правительство правительства
сотня: сотни сотен
тысяча: тысяч
репрессированный: репрессированных
реабилитировать: реабилитировать
продать: продать
америка: америка америке
израиль: израилю израиля израиль израиле
труд: труд трудом
построить: построят построен
твой: твоих твоей
мудрый: мудрых мудрым
отец: отец
дед: деда деды деде
позор: позор
ты: тебе
говорить: говорили говорят
натуральный: натуральные натурального
продукт: продукты
скудный: скудная
гуманитарный: гуманитарная
заболевание: заболеваний
учёный: учёных
исследование: исследований
иметь: имеет
гмо: гмо
продукция: продукции
содержаться: содержится
множество: множество
химикат: химикатов химикаты
голландский: голландская
помидор: помидорах помидоры помидоре
найти: найти найден
глутамат: глутамат
натрий: натрия
фрукт: фруктах фруктов фруктами
антиокислитель: антиокислители
краситель: красители
сендвич: сендвичи
содержать: содержали содержащим содержит содержащие
масло: масло
запретить: запретил запрещённые запрещены запретили
любой: любой
химия: химии
прекратить: прекратят прекратил прекратить
закупка: закупки закупку закупок
еда: еду
ввиду: ввиду
вред: вреда вреде
здоровье: здоровья здоровью здоровье
находиться: находятся находился находящиеся находится
использование: использования
освоение: освоение освоении
космос: космоса
никак: никак
распиаренный: распиаренному
илона: илон
маска: маска
несмотря: несмотря
вложить: вложенные
идти: идет идёт
обыкновенный: обыкновенная
лишний: лишних лишней
шум: шума
начать: начать
разрабатываться: разрабатываться
пилотировать: пилотируемый
космический: космического
корабль: корабль корабля корабли
параметр: параметров
превосходить: превосходить превосходят
ракета: ракеты
способный: способные
доставить: доставить
десять: десять десяти
закончиться: закончатся
именно: именно
полёт: полётами полётах полётов полете
список: список
расширяться: расширяется
мера: мер мере
перевод: перевода переводом
публикация: публикации
обряд: обряда обрядах обряд
освящение: освящения
волга: волги
недруг: недруги
столкнуться: столкнутся
очень: очень
серьёзный: серьёзные серьёзными серьёзнее
формулировка: формулировками
намного: намного
мид: мид
мария: мария
захаров: захарова
изяслав: изяслав
тарашкевич: тарашкевич
православный: православной православными
церковь: церкви
говориться: говорится
сообщение: сообщении сообщению сообщение
появиться: появится
страница: страница странице
социальный: социальной
сеть: сети
патриарх: патриарх
русь: руси
кирилл: кирилл
возглавлять: возглавляемой возглавлял
капеллан: капелланом
военный: военно военные военного
морской: морского
флот: флота
снарядить: снаряженной
святой: святой святого
вода: воды вода воде
течение: течению течение течении
неделя: неделю
спуститься: спуститься
освящать: освящая
река: рек
основа: основ основы
лежать: лежит лежащий
смесь: смесь
освятить: освященной
речной: речной
цель: целей цель целью
распространение: распространения
святость: святости
ниже: ниже
русло: руслу русло
несколько: несколько
населить: населённых
ход: ходе
маршрут: маршрута маршрутов маршруты
готовиться: готовится
станция: станций
дозаправка: дозаправки
обозначить: обозначенные обозначено
пит: пит
стопа: стопы
священнослужитель: священнослужители священнослужителя
пополнить: пополнить
запас: запасы запасов
ладан: ладана
постный: постной
семидневный: семидневного
ритуал: ритуал
назвать: назвал
возвращение: возвращение
исконно: исконно
русский: русскими русского русской русскую
помимо: помимо
описание: описании
действо: действа
план: планы план планах
проведение: проведения проведение
прочий: прочих
знаковый: знаковых
подготовка: подготовку
перечень: перечня
водный: водных
артерия: артерий
сразу: сразу
краеведческий: краеведческих
музей: музея музей
сообщество: сообщество сообществ сообщества
географ: географов
просветитель: просветителей
миклухо: миклухо
маклай: маклая
государственный: государственной
архив: архив архива
бог: боже
ежегодный: ежегодным ежегодными ежегодной ежегодное
фонд: фонд
бжезинский: бжезинского
помочь: помогут помогли поможет
победитель: победителем
всероссийский: всероссийский
школьный: школьного школьных школьную
олимпиада: олимпиад олимпиадах
поступить: поступить поступившему поступившей поступили поступила поступило
йельский: йельский йельского
университет: университетах
предпочесть: предпочёл
мой: моих моей моего мои
имя: имя имени именем
жерар: жерар
депардье: депардье
школьник: школьники школьников
лауреат: лауреата лауреатами
обществознание: обществознанию
право: права прав
получение: получение получения получением
грант: гранта
обучение: обучения
бакалавриат: бакалавриате
престижный: престижного престижна
совместно: совместно
прислать: пришли
вуз: вузов
збигнев: збигнева
оплатить: оплатит оплатить
учёба: учёбу
талантливый: талантливым талантливы
доступный: доступных доступен доступна доступным
учебный: учебного
программа: программы программой программе
призёр: призеров
войти: войдут
свобода: свободы свободу
клан: клана
ротшильд: ротшильдов
гендерный: гендерные
транскорпорация: транскорпорации
цивилизация: цивилизация
европа: европе европы
экономист: экономистов
патронаж: патронажем
мвф: мвф
всемирный: всемирного всемирном всемирный
банк: банка
дальнейший: дальнейшем дальнейшей дальнейшую
родина: родину
преимущественно: преимущественно
сми: сми
зарегистрировать: зарегистрированных зарегистрированные
статус: статус статуса
агент: агентов агентом
бывший: бывшего бывший
восточный: восточной восточную
трудиться: трудятся
немало: немало
выпускник: выпускников выпускники выпускникам
благо: блага
либеральный: либеральных
идея: идей идее
надеяться: надеюсь надеясь надеялись
ещё: ещё
поприветствовать: поприветствовал
член: член
администрация: администрация
леви: леви
зильберштейн: зильберштейн
выборы: выборы выборов
путём: путём
голосование: голосования голосовании голосованием
епископ: епископ
применять: применяет применяемой
рукоприкладство: рукоприкладство
лёгкий: лёгкой легкие легка легче лёгкая
форма: форме
юный: юным юном
прихожанин: прихожанам
раз: разу раза
нанести: нанесены нанесённая
телесный: телесные
повреждение: повреждения
бронислав: бронислав
рубенштейн: рубенштейн
католический: католическая
активный: активные активных
внедрять: внедрять
церковный: церковную
заявление: заявлением
пресс: пресс
секретарь: секретарь
престол: престола
кардинал: кардинал
паоло: паоло
дуронить: дурони
ватикан: ватикан
планировать: планируют планирует
создать: создаст созданный создал создавшему
иерарх: иерархов
оставаться: оставаться
архаичный: архаичным
пережиток: пережитком
прошлое: прошлого
большинство: большинство большинства
давно: давно
обосноваться: обосновались
интернет: интернета
сильный: сильна сильные сильных сильной
отставать: отстаёт
святейшество: святейшество
поручить: поручил
мы: нам
быстрый: быстрее быстрого
исправить: исправить исправлена
ошибка: ошибками ошибки
председатель: председатель
конгрегация: конгрегации
мирянин: мирян
архиепископ: архиепископ
маркус: маркус
цукерман: цукерман
сообщить: сообщил сообщила
скорый: скором
запуск: запуске
позволить: позволим позвольте
верующий: верующим
выбирать: выбирать
понтифик: понтифика
защита: защиту защитой
вмешательство: вмешательства
хакер: хакеров
желать: желающих
проголосовать: проголосовать
тест: тест тесте
вопрос: вопрос вопросам
знание: знаний
канонический: канонических
евангельский: евангельских
латинский: латинском
язык: язык языку языках
изучаться: изучается
снг: снг
напомнить: напомним напомнившего
всенародный: всенародным
митрополит: митрополит
токийский: токийский
даниил: даниил
нусиро: нусиро
ароматический: ароматический
бензин: бензина
ради: ради
токсикоман: токсикоманов
лавировать: лавировали
вылавировать: вылавировали
пётр: пётр
порошенко: порошенко
январь: января
нефтеперерабатывающий: нефтеперерабатывающие
перейти: перейдёт
выпуск: выпуск выпуске
дизельный: дизельного
топливо: топлива
сообщать: сообщает сообщают
причина: причиной причинам причин
рекомендация: рекомендации рекомендацию
здравоохранение: здравоохранения
связанный: связанных
увеличение: увеличением увеличения
количество: количество
погибнуть: погибших
токсикомания: токсикомании
судить: судя
жертва: жертв
вдыхание: вдыхания
пар: паров
увеличиться: увеличилась увеличившихся
составить: составил составят составит
человек: человек
токсикомать: токсикоманы
огромный: огромной
трудность: трудности
качественный: качественной
медицина: медициной
пятёрка: пятёрку
хороший: хорошее лучший лучшим лучших
этот: этих
какой: какие
глупый: глупых глупее
усилие: усилия
оказываться: оказываются
напрасный: напрасными
лечение: лечения
выделяться: выделяются
оборудование: оборудование оборудования оборудованием
профилактический: профилактические
беседа: беседы
приносить: приносили
пострадать: пострадавших
снова: снова
приниматься: принимались
старое: старое
вывод: выводу
переубедить: переубедить
поговорить: поговорили поговорить
производитель: производителями
послать: пошли
навстречу: навстречу
уоррен: уоррен
сноудон: сноудон
данный: данный
момент: момент
позволять: позволяет позволяющая
будущее: будущем
эвкалипт: эвкалипт
каркад: каркаде
шалфей: шалфей
мятый: мята
оценка: оценки
компания: компании
модернизация: модернизации
понадобиться: понадобится
порядок: порядка порядке
половина: половину половина
бюджет: бюджете бюджета
сокращение: сокращения
перенос: переноса
строительство: строительство
мост: моста мост
зеландия: зеландию
минпромторг: минпромторг минпромторга
официально: официально
нецензурный: нецензурную нецензурной
лексика: лексику лексики
коммунист: коммунистов
весить: весит
маленький: меньше
ленин: ленину
процент: проценту
правильный: правильных правильное
вообще: вообще
равный: равных равны
си: си
цзиньпинь: цзиньпинь
промышленность: промышленности
релиз: релизе
отчитаться: отчиталось
успешный: успешном
завершение: завершении завершения
трёхлетний: трехлетних
немой: нем
анонсироваться: анонсируется
пакет: пакет
поправка: поправок поправку
законопроект: законопроект законопроекта
продуктивность: продуктивности
производственный: производственных производственный
объект: объекты объект
оставлять: оставляет оставляют
задача: задачей
вернуть: вернуть
тройка: тройку
ведущий: ведущему ведущие ведущих ведущими
наметить: намечен
пятилетний: пятилетний
необходимый: необходимая необходимых необходимый необходимой
собрать: собрали
обработать: обработана
дата: даты
денис: денис
мантур: мантуров
подобный: подобной подобные подобным подобную подобное
удалость: удалость
применение: применения
новаторский: новаторских
практика: практике
менеджмент: менеджмента
собранный: собранные
мат: мата мат
грубый: грубой
брань: брани
сокращать: сокращает
речь: речь
повелительный: повелительном
наклонение: наклонении
стимулировать: стимулирует
осознанный: осознанным
чувствовать: чувствовать чувствовал
дом: дом
благоприятно: благоприятно
сказываться: сказывается
мотивация: мотивации мотивацию
следовательно: следовательно
разрешить: разрешили разрешила разрешить
рекомендовать: рекомендован рекомендованных рекомендует рекомендовали рекомендую
промышленный: промышленных
изменение: изменения
законодательство: законодательству
вступить: вступят вступил
сила: сил
редакция: редакции
перепроверка: перепроверки
речевой: речевых
оборот: оборотов
выплата: выплаты
аренда: аренду
аляска: аляска
калифорния: калифорния калифорнии
устранение: устранения
блокировка: блокировки
изменить: изменить
административно: административно
территориальный: территориальной
соответствие: соответствии
правило: правила
дональд: дональд
трамп: трамп
подписать: подписать
закон: закон законом закона законы
отказываться: отказываются отказываться
вмешиваться: вмешивающихся
приостановить: приостановлены
штат: штат штате штатов
минфин: минфина
трлн: трлн
ежегодно: ежегодно
тратить: тратить
налогоплательщик: налогоплательщиков
финансирование: финансирование финансирования
подрывать: подрывающих
постыдный: постыдной
платить: платить
входящий: входящие
состав: составе составов
заседание: заседании
конгресс: конгресса конгресс
сенатор: сенатор
оклахома: оклахомы
бен: бен
ганна: ганн
передать: переданные
бессрочный: бессрочную
император: императором
два: две
поздний: позже
минстат: минстата
ввп: ввп
период: период
роскосмос: роскосмос роскосмоса
ремонтировать: ремонтировать
туалет: туалет туалетов
мкс: мкс
гермослава: гермослав
томилина: томилин
корпорация: корпорация корпорации
объявить: объявила
отказ: отказ
сломать: сломанный
декабрь: декабре
международный: международной международными международная
мотивировать: мотивировал мотивирует
нерациональность: нерациональностью
затрата: затрат затраты затратах
восстановление: восстановление восстановления
функция: функций функцию функциями
унитаз: унитаза унитаз унитазы
ответный: ответными
антироссийский: антироссийские
сторона: стороны
прекрасно: прекрасно
понимать: понимаю
неудобство: неудобства
испытывать: испытывают
космонавт: космонавты космонавтами
понять: поняли
правильно: правильно
миллион: миллионов миллионы
подготовить: подготовить подготовили
сантехника: сантехника
нерационально: нерационально
пусть: пусть
заниматься: заниматься
коллега: коллегу коллега коллегами коллег коллеги
поломать: поломали поломаны
чинить: чиним
пояснить: пояснил
сантехник: сантехник
кулибин: кулибин
пребывать: пребывающие
цуп: цуп
неисправный: неисправный
приходиться: приходится
справлять: справлять
нужда: нужду нуждам
запасный: запасные
скафандр: скафандры
рязань: рязани
памятник: памятник памятники
чингисхан: чингисханом
честь: честь
летие: летия летию
установление: установления
дипотношение: дипотношений
монголия: монголию
рад: рад
традиционный: традиционные традиционную традиционных традиционное
сексуальный: сексуальную
ориентация: ориентацию ориентации
артист: артисту
балет: балета
юнг: юнг
советник: советник
дипломатический: дипломатический дипломатического
отношение: отношений отношения отношении отношение отношению
отметить: отметить отметила
визит: визита
рязанский: рязанскую рязанской
область: области
договориться: договорились договорившись договориться
посол: посол
дэлгэрмаа: дэлгэрмаа
банзрагчийна: банзрагчийн
мэр: мэра мэром мэр
сергей: сергей
карабас: карабасов
связывать: связывают
многовековый: многовековые
дружеский: дружеские
выдающийся: выдающийся выдающимися выдающегося
полководец: полководец полководцу
бывать: бывал бывают бывает
возвращаться: возвращается
напоминание: напоминанием
прекрасный: прекрасным
монгольский: монгольский монгольскому монгольского
дипломат: дипломат
видеть: видел видела видят
грандиозный: грандиозный грандиозного
бумага: бумаге бумага бумаги
визитный: визитной
карточка: карточку
увидеть: увидел увидели
живьём: живьём
мечтать: мечтать
турист: туристов
уголок: уголков
свет: света свет
ранний: раньше
масштабный: масштабные масштабными
реализовываться: реализовывались
петербург: петербурга петербурге
волгоград: волгограде
дополнить: дополнил
монумент: монумент
возвышаться: возвышаться
метр: метра метрах
напоминать: напоминать
конный: конную
статуя: статую
цонжина: цонжин
болдог: болдоге
считаться: считающуюся считаются считалось
самый: самым самый
сооружение: сооружение
оба: обе
основной: основной
расход: расходы
содержание: содержание содержании содержания
комплекс: комплекса комплексов
понести: понесёт
монгол: монголы
предоставить: предоставят предоставила
сентябрь: сентябре сентября
завершить: завершить завершил
весна: весной
разный: разное разных
подсчёт: подсчётам
потребоваться: потребовалось
прокуратура: прокуратура
подсчитать: подсчитает
овощ: овощей овощами овощи
доширак: дошираке доширак
путин: путина
приезжать: приезжай
беловежский: беловежскую
пустить: пущу
проверка: проверки
возможный: возможных
недокладывания: недокладывания
популярный: популярной популярный
лапша: лапшу
приготовление: приготовления
соответствовать: соответствующей
инициатива: инициатива
надзорный: надзорного надзорных надзорные
ведомство: ведомства ведомстве
распоряжение: распоряжению
ответственный: ответственным ответственную
контрольный: контрольно контрольной
ревизионный: ревизионные
дегустационный: дегустационные
мероприятие: мероприятия мероприятиях
решаться: решается решаться
выделение: выделении
образец: образцов образца
упомянуть: упомянутой
назначить: назначена назначено назначить
экспертиза: экспертиза экспертизы
объём: объём
разработка: разработкой разработке
методология: методологии
случай: случае случай
нехватка: нехватки нехватке нехватка
превышение: превышения
допустимый: допустимой
погрешность: погрешности
масса: массы
подтвердить: подтверждены подтвердила подтверждённые подтвердит
независимый: независимой
экспертный: экспертной
предстоять: предстоит
степень: степень степенях степенью степени
влияние: влияния влияние
нарушение: нарушения
техпроцесс: техпроцесса
вкусовой: вкусовые
итог: итоге
процессуальный: процессуальное
южноафриканский: южноафриканские южноафриканским
страус: страусы страусов
впасть: впали
депрессия: депрессию
встреча: встречи встрече
леди: леди
ходить: ходим ходили ходить
отслеживать: отслеживаем отслеживать
фьючерс: фьючерсам
варфоломей: варфоломей
константинопольский: константинопольский
необычный: необычный
спасательный: спасательная спасательных
операция: операция
проходить: проходил проходившего
африканский: африканской
эммануэль: эммануэля
макрон: макрона макрон
супруг: супруги
брижит: брижит
посетить: посетить посетили
страусиный: страусиную
ферма: ферму
отмечать: отмечает
птица: птиц птицу
паника: панику
опустить: опустили
голова: голове
песок: песок
возможно: возможно
мадам: мадам
устать: уставшей
длительный: длительного длительные
перелёт: перелёта перелёт
выглядеть: выглядела выглядеть выглядит
испугать: испугать
птичка: птичек
магнитный: магнитная
буря: буря
прогнозироваться: прогнозировалась
день: день дне
спасать: спасать спасает
хозяин: хозяин хозяева хозяев
майкл: майкл
обасся: обасси
продолжаться: продолжающуюся
третий: третий третьего
побудить: побудило побудила
стандартный: стандартные стандартного
метод: методы метода методов
вой: вой
динамик: динамиков
нашатырный: нашатырный
спирт: спирт
тяжёлый: тяжёлый тяжёлым тяжёлые тяжелее
задействовать: задействованы задействованными
бульдозер: бульдозером
спасатель: спасатели
попытаться: попыталась
откопать: откопать
птичий: птичьи
выразить: выразил выражено
сожаление: сожалению
неприятный: неприятный
ситуация: ситуацию
пообещать: пообещали пообещал пообещала пообещавшие
разработать: разработать разработали
пособие: пособие пособия
лицо: лиц
посещение: посещении посещение посещения
зооферма: зооферм
крым: крыму крыма
пресечь: пресекли
экскурсия: экскурсии
разместить: разместили разместить
ребёнок: детей
колония: колонии
элтон: элтон элтона
любить: любит любил люблю
дагестан: дагестан дагестана
джон: джон
правоохранительный: правоохранительных
санкт: санкт
организовать: организованную организованной организовавшей
городской: городской
лицей: лицеев
выясниться: выяснилось
заведение: заведения заведении
отправить: отправило отправят отправленный отправить
педагог: педагоги педагог
полуостров: полуострова
оформить: оформив оформлена
поездка: поездкой поездке поездки
отдел: отдела
образование: образования
отработка: отработке
оперативный: оперативной оперативных
керчь: керчи
задержать: задержали задержанные
несовершеннолетний: несовершеннолетних
совершеннолетний: совершеннолетних
осуществлять: осуществляли
туристический: туристическую
оформление: оформления
надлежащий: надлежащих
служба: службе служба
выяснение: выяснения выяснений
обстоятельство: обстоятельств
подписка: подписки
невыезд: невыезде
обратно: обратно
поиск: поиск поиски
транспорт: транспорт
юридический: юридического
характер: характера характер
исправительный: исправительной
иной: иных
свободный: свободных свободном свободным
помещение: помещений помещениях
проживание: проживания
заверить: заверил заверить
безопасно: безопасно
рецидив: рецидивы
преступление: преступлений преступлении преступления
против: против
детский: детскую
сад: сады
армейский: армейского армейские
тип: типа
минобороны: минобороны
открыть: открыл
проблема: проблемы проблем
дошкольный: дошкольных дошкольные
патриотический: патриотического патриотических патриотические
воспитание: воспитания
заявлять: заявляют заявляю
пустовать: пустующих
действовать: действующему
воинский: воинских
скорректировать: скорректирована
уклад: уклада
занятие: занятиях занятие занятиям занятия занятий
рисование: рисованию
учиться: учимся
делать: делать делают
полевой: полевые
карта: карты карту карте
пение: пению
учить: учить учим
песня: песня песни песням
марш: марши марш
физкультура: физкультуре
упор: упор
строевой: строевую
преодоление: преодоление
полоса: полосы
препятствие: препятствий
особый: особое особая особые особую особым
воспитательный: воспитательной
занять: займёт
изучение: изучения
боевой: боевой
нато: нато
родитель: родителей
приводить: приводить приводит
чадо: чад
они: ними
заключаться: заключаться заключалась заключается
контракт: контракты контрактами
рамка: рамках
воспитанник: воспитаннику
ежемесячный: ежемесячная ежемесячному
стипендия: стипендия
мнение: мнению
чиновник: чиновники
сократить: сократить
очередь: очередей очередь
сформировать: сформировать сформированы
потенциальный: потенциальный
резерв: резерв резерва
офицерский: офицерского
анапа: анапе
площадка: площадку
макет: макетами
вооружение: вооружения
презентовать: презентовали
вариант: вариант варианты
учебник: учебника учебники
корректный: корректные
извинение: извинения
гость: гостями гости гостей
африка: африки
невыполнение: невыполнение
контрактный: контрактных
обязательство: обязательств
рональд: рональд
райтлингер: райтлингер
григорий: григорий
касаткин: касаткин
сотрудничество: сотрудничестве
немецкий: немецких немецкой
языковед: языковедами
филолог: филологами
федеральный: федеральных федеральным федерального
научный: научных
представить: представьте
политкорректный: политкорректный
внимание: внимание
уделить: уделено
кроме: кроме
обращение: обращения
иностранец: иностранцам
ознакомиться: ознакомиться
кулинарный: кулинарными
предпочтение: предпочтениями
тенденция: тенденциями
мода: моды
религиозный: религиозных
обычай: обычаев
полноценный: полноценными
социум: социума
научиться: научимся научились научатся научиться
научить: научат
взаимодействовать: взаимодействовать
никто: никто
нужный: нужен нужным
фрг: фрг
аня: аня
карличка: карличек
правозащитник: правозащитники
дисквалифицировать: дисквалифицировать
омский: омский омского
газмясти: газмяс
осознавать: осознаю осознавать
важный: важную важного важном
роль: роль
алюминий: алюминия
даровать: даровал
металл: металлу
господь: господь
обратиться: обратились обратился обратиться обратилась
письмо: письма
рфс: рфс
футбольный: футбольного футбольном футбольные
требование: требованием требование
дисквалификация: дисквалификации
вымышленный: вымышленного
клуб: клуба
насилие: насилием
тренер: тренер
игрок: игроков игроку
руководитель: руководитель
малкольм: малкольм
кун: кун
садизм: садизме
пытка: пытках
просмотр: просмотра
юмористический: юмористической
передача: передачи передаче
выходить: выходить
тнт: тнт
ужасно: ужасно
цивилизованный: цивилизованных
тренировать: тренирует
спортсмен: спортсмены спортсмен
любительский: любительском
видео: видео
заставить: заставил заставила
переодеться: переодеться
женщина: женщины женщин
поле: поле
пропаганда: пропаганды
демонстрировать: демонстрируют
прайма: прайм
тайм: тайм
рейтинговый: рейтинговом
сопровождать: сопровождая
смех: смехом
телезритель: телезрителей
направить: направила
уефа: уефа
исключить: исключили исключены
соревнование: соревнованиях соревнований
вынести: вынести вынесли вынес вынесут вынесет
пожизненный: пожизненный
спорт: спорта
михаил: михаил
галустян: галустяна
сатирическо: сатирическо
телепередача: телепередача телепередачам
транслировать: транслируемая
ноябрь: ноября
присутствовать: присутствующих
сюжетный: сюжетных
линия: линий линии линия
постоянно: постоянно
проигрывать: проигрывающего проигрывали
евгений: евгений
кишельский: кишельский
галустянин: галустян
физический: физического физическому физический
воздействие: воздействия воздействием
стихотворение: стихотворений
пушкин: пушкина
поэт: поэта поэт
признаваться: признается
любовь: любви
впервые: впервые
убийство: убийстве
го: го
прочитать: прочитал
остальной: остальных остальные
перепечатывать: перепечатывали
кеннеди: кеннеди
пушкинист: пушкинистов пушкинисты
кавказский: кавказской
экспедиция: экспедиции
неизвестный: неизвестных неизвестные
рассказывать: рассказывает рассказывать
давний: давнему
приятель: приятелю
историк: историку историк
николай: николаю николай
карамзин: карамзину
желание: желанием
перевести: перевести переведённый переведены перевёл
поэма: поэму
руслан: руслан
людмила: людмила
английский: английском
удобство: удобства
читатель: читателя читателей
оригинал: оригинал
пока: пока
широкий: широкой широкую широкие шире
публика: публике публика публики
исследователь: исследователи
весьма: весьма
нелестно: нелестно
отзываться: отзывался
единственный: единственная
возможность: возможность
привнести: привнести
капля: каплю
захолустье: захолустье
посвятить: посвятил посвящена посвященную посвящённая
живой: жива жив живому живых
привет: привет
струиться: струится
мистерика: мистерикой
вечерний: вечерний
несказанный: несказанный
успокоиться: успокойся
тягостный: тягостная
бредить: бредь
пропойца: пропойца
умереть: умереть
будить: буди
отмечтаться: отмечталось
волновать: волнуй
сбыться: сбылось
слишком: слишком
утрата: утрату
усталость: усталость
испытать: испытать
довестись: довелось
молиться: молиться
старый: старому старые
возврат: возврата
отрада: отрада
православие: православью
дружно: дружно
скажем: скажем
обещать: обещают
квота: квоту
даун: дауна
тиран: тираном
чувство: чувством
юмор: юмора
соломон: соломон
жидков: жидков
деятельность: деятельности деятельность
вводиться: вводится
набор: набор
синдром: синдромом
объяснить: объяснили
устранить: устранить устранили
дискриминация: дискриминацию
ограниченный: ограниченными
умственный: умственной
доказать: доказано доказали доказать
болезнь: болезнью
разновидность: разновидность
работоспособный: работоспособны
доброта: доброты
обычный: обычный обычной
фора: фору
большой: большого большой
прогресс: прогресса
прошлый: прошлом прошлый
крупный: крупных крупной крупнейших
сегодня: сегодня
красота: красота
глубина: глубина
уверить: уверена
солнечный: солнечные солнечных
потомок: потомки потомков
демократический: демократической демократический
пэтти: пэтти
мюррей: мюррей
приверженность: приверженность
управлять: управлять управляющего
почему: почему
ограждать: ограждаем
хиллари: хиллари
клинтон: клинтон
методика: методики
больной: больных
покорить: покорить
простор: просторы
вселенная: вселенной
журналистка: журналистка журналистку
нидерланды: нидерландах
месяц: месяц месяцы месяцев месяца
бордель: борделе
документальный: документального документальную
эпоха: эпохи эпоха
летосчисление: летосчисление
касым: касым
жомарт: жомарт
токай: токаев
казахстан: казахстан
нидерландский: нидерландского нидерландской нидерландская
бриджито: бриджит
биркеланда: биркеланд
решиться: решилась решится
эксперимент: эксперимент
проработать: проработать
оказание: оказанию
интим: интим
услуга: услуг услуги услугах
развенчиваться: развенчивались
стереотип: стереотипы
относительно: относительно
зарабатывать: зарабатываемых
жрица: жрицами жриц
немного: немного
непривычно: непривычно
оказывать: оказывать
клиент: клиенты
совершенно: совершенно
отличаться: отличается
журналист: журналист
наставница: наставницы
быстро: быстро
адаптироваться: адаптироваться
заработать: заработать
прибавка: прибавку
довольный: доволен довольны довольна
представительница: представительницы
справиться: справиться
обязанность: обязанностями
заверять: заверял заверяют
захотеть: захочет захотела
гореть: горящими горящему
глаз: глаза глазам
посетитель: посетители посетителя
жаль: жаль
телевидение: телевидение
её: её
хватать: хватать
ростов: ростове
дон: дону
танцующий: танцующему танцующим
ельцин: ельцина ельцину
объяснительный: объяснительные
изучить: изучим изученные изучить
протяжение: протяжении
оборона: обороны
эстония: эстонией
рихо: рихо
терраса: террас
открытие: открытии открытие открытию
запечатлеть: запечатлён
стадион: стадион стадиону
олимп: олимп
июнь: июня
концерт: концерт
голосовать: голосуй голосовавшего
проиграть: проиграешь проиграли
пуститься: пустился
пляс: пляс
пожертвование: пожертвований
благодарный: благодарен благодарным
ростовчанин: ростовчан
рядом: рядом
выставить: выставлены выставить
редкий: редкие редких
фото: фото
голос: голос
динамика: динамика
интересный: интересных интересные интересную
подробность: подробностях
биография: биографии
казачий: казачьего казачьим
хор: хора
таганрог: таганрога
молодёжный: молодёжный молодёжного
исполнитель: исполнитель
осина: осин
целое: целого
пойти: пойдут
отменить: отменила отменён отменили
проезд: проезд
пенсионер: пенсионеров пенсионер пенсионерам пенсионеры
искренне: искренне
радоваться: радоваться радуется
простой: простым
вещь: вещам вещи вещей вещь
джинсы: джинсы
туалетный: туалетная
сырокопчёный: сырокопченая
колбаса: колбаса
полноценно: полноценно
дышать: дышал
грудь: грудью грудь
генри: генри
киссинджер: киссинджер
завести: завели
уголовный: уголовное
четырёхмиллионный: четырехмиллионного
тайюань: тайюань тайюаня
шаньсить: шаньси
материал: материала материалом
намереваться: намеревались намеревался
невыгодный: невыгодных
оптимизация: оптимизации
горожанин: горожан
мэрия: мэрия
пекин: пекин
спустя: спустя
оцепить: оцепили
полиграф: полиграфе
готовить: готовить готовят
подпадать: подпадают подпадает
понятие: понятие
долгий: долгие долгих долгое
лагерь: лагерях
остановить: остановить остановил
обвинение: обвинения
недоносительство: недоносительстве
должность: должности
неотъемлемый: неотъемлемое
пожилой: пожилых пожилую
заслужить: заслуживших заслуженные заслужили заслуженную
спокойный: спокойный спокойная
отдых: отдых отдыхе
соответствующий: соответствующие
льгота: льготы льготами
уважать: уважает
старик: стариков старики
опозорить: опозорить
слуга: слуги
делегировать: делегировано
великое: великое
защищать: защищать защищает
интерес: интересы интерес
служить: служить
комментировать: комментируя
громкий: громкое
особенный: особенной особенных
подсудимый: подсудимых
судебный: судебного
массовый: массовую
адвокат: адвокатов адвокат
адвокатский: адвокатской
палата: палаты палату
позорить: позорят
юрист: юриста юрист
видимость: видимости
самостоятельно: самостоятельно
роспотребнадзор: роспотребнадзор
закупить: закупит закупили
муха: мух
определение: определения
арбуз: арбузов арбузами
увы: увы
ричард: ричард
макларен: макларен
узбекистан: узбекистана
киргизия: киргизии
таджикистан: таджикистане таджикистана
плод: плодов
бахчевый: бахчевых
насекомое: насекомых
точно: точно
определить: определить определили
пригодность: пригодность
употребление: употребления употреблении
ягода: ягод
начинаться: начинается
сезон: сезон
стараться: стараемся стараюсь старается
проверять: проверять
сертифицированный: сертифицированных
лаборатория: лабораториях
застраховать: застрахованы
входить: входить
сговор: сговор
вспоминать: вспоминаю вспоминал вспоминая
детство: детстве
буквально: буквально
рой: роем
кружить: кружили
обозначать: обозначало
измениться: изменилось
обмануть: обманешь обманули
подкупить: подкупишь
надёжный: надёжный
анна: анна
попов: попова
азия: азии
лабораторный: лабораторным
заметно: заметно
астраханский: астраханской
волгоградский: волгоградскому волгоградской
краснодарский: краснодарского
поставка: поставки
среднеазиатский: среднеазиатских
начаться: начнутся начался началось началась начаться начались
собака: собак
росгвардия: росгвардии
получать: получать
пенсия: пенсию пенсии
обработка: обработка
газ: газом
выявить: выявить
текстура: текстуру
дерево: дерева
константин: константин
львович: львович
пенсионный: пенсионного
повышаться: повышаться
служебный: служебным служебный
источник: источник источники источников
собачий: собачий
решить: решил решили решит
приравнять: приравнять
поскольку: поскольку
выслуга: выслуга
силовик: силовиков
выход: выхода
четвероногий: четвероногим
помощник: помощникам
достаточно: достаточно
отслужить: отслужить
поступление: поступлений
пфр: пфр
мвд: мвд
фсб: фсб
обеспечивать: обеспечивать обеспечивает
должный: должны
уход: уход
среди: среди
зоозащитник: зоозащитников
законодательно: законодательно
арабский: арабский
марсел: марселе
марсель: марселя
придание: придании
объединение: объединения
имам: имамов
бадром: бадром
эль: эль
ахдить: ахди
прислушаться: прислушавшись
аргумент: аргументам
марселец: марсельцам
нелегко: нелегко
даваться: даётся даются
трудно: трудно
он: нём нему
писать: писать
менее: менее
нужно: нужно
общаться: общаться общаются
друг: друг другом друзьям
иначе: иначе
мсьё: мсье
джихад: джихад
сложно: сложно
выучить: выучить
легко: легко
думать: думал
мусульманский: мусульманская
община: община
переезд: переезд
гавр: гавр
лион: лион
жан: жан
клод: клод
годэн: годэн
отныне: отныне
объявление: объявлений
дублироваться: дублироваться
вывеска: вывесок
собственность: собственности
муниципальный: муниципальные
медик: медики медикам медиков
полицейский: полицейские полицейского полицейскими полицейском
берлинский: берлинский
шариатский: шариатский
конституция: конституцию конституции
норма: нормы
ислам: ислама
предлагать: предлагаю предлагал предлагаем предлагали предлагают
застройка: застройку
капсульный: капсульным
жильё: жильём
мутко: мутко
верховный: верховный
иск: иску иск иска
судья: судья
идрис: идриса
аль: аль
шахравить: шахрави
точка: точке точки
зрение: зрения
ужасный: ужасный
необходимо: необходимо
перерабатывать: перерабатывать
правоверный: правоверным
мусульманин: мусульманам
разрешаться: разрешается
вытекать: вытекающим
подчиняться: подчиняющимся
аллах: аллаха
пророк: пророков
иншааллах: иншааллах
волнение: волнение
политик: политиков политиками
дневный: дневный
оспорить: оспорить
меркель: меркель
госслужащий: госслужащих
митинг: митингах
правящий: правящей
хдс: хдс
христианско: христианско
акция: акция акций
служащий: служащих
госкомпания: госкомпаний
лпг: лпг
левый: левой
сара: сары
вагенкнехт: вагенкнехт
подать: подал
октябрь: октябре октябрь октября
касаться: касающийся касающихся
парламентский: парламентской
предвыборный: предвыборной
кампания: кампании
канцлер: канцлера
вывести: вывела
бундестаг: бундестага
фактор: факторами факторов
добровольный: добровольное добровольном
согласие: согласие
что: чём
иметься: имеются
соответственно: соответственно
участие: участие участию
противоречить: противоречит
материальный: материальные
премия: премии премия
дополнительный: дополнительная
выходной: выходной
справедливый: справедливое
согласовать: согласованное
навсегда: навсегда
разбирательство: разбирательстве
очернить: очернить
оппонент: оппоненты
звонить: звонил
фрау: фрау
госслужащ: госслужащах
абсолютно: абсолютно
добровольно: добровольно
отреагировать: отреагировал отреагировала
мартин: мартин
кляйферт: кляйферт
открыться: открылся
копрологический: копрологический копрологические
санаторий: санаторий
эй: эй
пи: пи
ор: ор
специально: специально
плодородный: плодородной
открывать: открывает
ворота: ворота
школа: школы школа школах
батрак: батраков
герман: герман
стерлигов: стерлигов
фермер: фермерам фермер
июль: июля
черноморский: черноморском
побережье: побережье
лечебный: лечебные
животное: животных животные
экскремент: экскременты экскрементов
терапевтический: терапевтических терапевтическими
врач: врачи врача
выбор: выбор выбором выбора
обусловить: обусловлен
теплоёмкость: теплоемкостью
фекалия: фекалий
малый: малой малейшие малая
теплопроводность: теплопроводностью
оптимальный: оптимальное
прогревание: прогревание
пациент: пациент пациента пациентов
крымский: крымские
доктор: доктор
целебный: целебные целебное
свойство: свойства
каловый: каловых
сто: ста
назад: назад
вещество: вещества веществом
подходить: подходит
сустав: суставов
нежели: нежели
парафин: парафин
озокерит: озокерит
различный: различные различный
грязь: грязи грязями
лечебница: лечебницы лечебница
сначала: сначала
курорт: курортах курортов
кавказ: кавказа
обрести: обрели
популярность: популярность популярности популярностью
санаторный: санаторно
курортный: курортный
отпуск: отпуск
путёвка: путевкам путёвка
удовольствие: удовольствием удовольствия
отправляться: отправлялись
деятель: деятелей
партийный: партийная
номенклатура: номенклатура
семья: семьи
кпсс: кпсс
упразднить: упразднить
развитие: развитие
инфраструктура: инфраструктуры
оздоровительный: оздоровительных
анастасия: анастасия
коновалов: коновалова
стремительно: стремительно
завоёвывать: завоевывает
крымчанин: крымчан
знаменитый: знаменитой
ванна: ваннах ванн
поправить: поправили
районный: районных районного
аксёнов: аксёнов
коровий: коровье
добришко: добришко
тепловой: тепловых
биологически: биологически
торфяной: торфяными
коровушка: коровушку
назначать: назначаем
местно: местно
аппликация: аппликацией
намазывать: намазываем
рубашечка: рубашечкой
сапожок: сапожком
наслоить: наслоить
массаж: массажа
промассировать: промассированное
тело: тела
остылый: остыло
воздействовать: воздействовать воздействует
организм: организм организмов организмам
ванночка: ванночку
поросячий: поросячьей
радость: радостью радости
плохой: хуже
держать: держит держите
тепло: тепло
поделиться: поделилась
секрет: секретами секрет
физиотерапевт: физиотерапевт
ангелина: ангелина
разумовский: разумовская
предупредить: предупредили
жизнедеятельность: жизнедеятельности
категорически: категорически
самолечение: самолечением
домашний: домашних домашнем домашнюю
назначение: назначения
британский: британский
опасность: опасности
мытьё: мытья
шампунь: шампуня шампунь
дурачок: дурачок
заучка: заучка
выбрать: выбрать
комикс: комикса
манчестер: манчестера
нести: несёт
опыт: опытов
частый: чаще
убиваться: убивается
клетка: клеток клетки
отвечать: отвечающих
интеллект: интеллект интеллекта
безусловно: безусловно
плохо: плохо
влиять: влияет
корневой: корневую
структура: структуру
волос: волос
ускорять: ускоряет
выпадение: выпадение
страшный: страшное
идиот: идиотом идиот идиотами
счастие: счастью
процесс: процесс
головной: головных головным
мозг: мозга
восстанавливаться: восстанавливаться
однажды: однажды
спасти: спас
неприятность: неприятности
джонсон: джонсона
советовать: советуют
планета: планете
пересмотреть: пересмотреть
гигиенический: гигиенические
взгляд: взгляды взгляд
крайний: крайнем крайней
мыть: мыть
неудобно: неудобно
дорогой: дороже дорогих
химический: химических
мэтт: мэтт
киллингсворт: киллингсворт
идеальный: идеальным
безопасный: безопасны безопасный
хозяйственный: хозяйственное
мыло: мыло
критик: критикам критиков
подпендоснуть: подпендоснутых
ложить: ложили
трудный: трудное
гдр: гдр
вокруг: вокруг
нецензурно: нецензурно
выражаться: выражались
ангела: ангела
критика: критику
шутка: шутки
пост: пост
лавров: лавров
прикладывать: прикладывать
географический: географических
эффект: эффект
экзорцизм: экзорцизма
заподозрить: заподозрили
аккаунт: аккаунт аккаунта
замедлить: замедлило
реакция: реакцией
патриотически: патриотически
недовольный: недовольным недовольных
посоветовать: посоветовали
валить: валить
сшп: сшп
кировчанка: кировчанку
справка: справку справка
участковый: участкового
выпускница: выпускницу выпускнице
педагогический: педагогического педагогических
алин: алину
киров: кирове кирова
крещение: крещении крещение
вероисповедание: вероисповедании вероисповедания
девушка: девушка
требовать: требовала требуем требовали
учитель: учителем
общеобразовательный: общеобразовательной
батюшка: батюшки
удивить: удивлена
услышать: услышала услышал
нечего: нечего
храм: храма храмах храм
ресепшний: ресепшне
записать: записали записал
настоятель: настоятель
кабинет: кабинете кабинетов
адок: адок
пускать: пускала пускают
секретарша: секретарша
талон: талоне
указать: указано указать
запись: запись
переделывать: переделывать
перекрикивание: перекрикивания
впустить: впустить
здравствуй: здрасьте
добро: добро
пожаловать: пожаловать
предъявить: предъявить
нательный: нательный
крест: крест кресту
веровать: верующая
подготовиться: подготовилась
подруга: подруги подруге
давать: даёт давали
допытываться: допытываться
крестить: крестили
спрашивать: спрашивал
выдавать: выдавать
заново: заново
изворачиваться: изворачиваться
долго: долго
получиться: получилось
помнить: помнят помни
выпучиться: выпучился
значит: значит
безбожница: безбожница
алина: алина
устроиться: устроиться
канадский: канадский канадскому канадским
кокаин: кокаин
вернуться: вернётся вернуться
чемпионат: чемпионат
футбол: футболу
темнокожий: темнокожих
алистер: алистер
маккей: маккей
интервью: интервью
газета: газете газета
крайне: крайне
дремучий: дремучую
ущемлять: ущемляющую
приехать: приехали приехало приехавшие приедут
неотёсанный: неотесанных
белый: белых белый белыми
дикарь: дикарей
насладиться: насладиться
оказаться: оказался
свободно: свободно
покупать: покупать покупала
наркотик: наркотиками
марихуана: марихуаны марихуаной
ежедневно: ежедневно
находить: находить находит
подпольный: подпольных
торговец: торговцев
продавать: продают продавал
уступать: уступающий
бесплатно: бесплатно
раздавать: раздают
слышать: слышал
недавно: недавно
парень: парень
автобус: автобусе автобусом автобус автобусы
врезаться: врезался врезаются
остановка: остановку остановках
богатый: богатые
употреблять: употребляют употреблять употребляет употреблявшего
машина: машина
канадец: канадец
оставить: оставил оставит оставила
координата: координаты
сравнить: сравнить сравните
вкус: вкус вкусом
бургомистр: бургомистр бургомистра
австрийский: австрийского австрийский
притворяться: притворялся
остров: остров
заложить: заложенный
основание: основание
пластик: пластик
плавание: плавании
кабусы: кабус
саид: саид
султан: султан
оман: омана
обманывать: обманывал
линц: линца
градоначальник: градоначальник градоначальника
петер: петер
руккер: руккера
пребывание: пребывания
марита: мариту
гонгельшаус: гонгельшаус
переизбираться: переизбирался
перевоплощение: перевоплощение
феминистический: феминистических феминистического
традиция: традиций традиции традициях
фактически: фактически
допускать: допускали
мизерный: мизерным мизерных
принципиальный: принципиальный
длиться: длившаяся
неожиданно: неожиданно
прерваться: прервалась
площадь: площади площадью
воскресный: воскресной
продовольственный: продовольственной
ярмарка: ярмарки
приветственный: приветственного
подвести: подвёл
предательски: предательски
соскользнуть: соскользнувший
парик: парик
небритый: небритую
борода: бороду
заверение: заверения
родственница: родственницей
певица: певицы
кончита: кончиты
вюрстый: вюрст
разозлить: разозлили
обманщик: обманщика
полететь: полетели
огурец: огурцы
цукиня: цукини
произвол: произвол
прибыть: прибывшая
происшествие: происшествия
окружный: окружной
верхний: верхней
австрия: австрии
оправдательный: оправдательный
приговор: приговор
посчитать: посчитав
правомерный: правомерным
отстранение: отстранение
соглашение: соглашению
народный: народным народной народные
феминистка: феминистке
предотвращение: предотвращения
экс: экс
подвергнуть: подвергнут
процедура: процедуре
остракизм: остракизма
покинуть: покинет покинули
постепенный: постепенное
возраст: возрасте
баку: баку
славный: славная
спасибо: спасибо
ной: ной
капитан: капитан
ковчег: ковчега
кнр: кнр
исходить: исходя
зачастую: зачастую
переутомление: переутомлению
депрессивный: депрессивным
расстройство: расстройствам
сталинский: сталинских
намерить: намерено намерены
снизить: снизить
компартия: компартии
волноваться: волноваться волнуйтесь
последствие: последствиях последствий
заменять: заменять заменяют
позаботиться: позаботиться
улучшать: улучшать улучшает
поощрять: поощрять
равно: равно
китаец: китайцы
пример: пример примеру
соседний: соседней
вон: вон
затем: затем
ежемесячно: ежемесячно
субсидия: субсидией субсидий
эквивалентный: эквивалентной
заграничный: заграничные
путешествие: путешествия
аналог: аналог аналогов
выйти: выйти вышла вышли
аналогичный: аналогичные аналогичную
вознаграждение: вознаграждения
отдыхать: отдыхают отдыхавшую
дружественный: дружественных
дальний: дальних
товарищ: товарищей
хулиган: хулиганы хулиган
превратить: превратили превратив
горный: горно
алтайск: алтайск
порно: порно
жандарм: жандарма
спина: спиной
элла: элла
памфилов: памфилова
цик: цик
вандализм: вандализма
выезд: выезде
поиздеваться: поиздевалась
добавить: добавил добавила добавили
буква: букве буквой букв буквы
палочка: палочку
снизу: снизу
заметить: заметил
правоохранитель: правоохранители
дактилоскопический: дактилоскопической
картотека: картотеки
наслать: нашли
виновный: виновных
студент: студент
филологический: филологического
факультет: факультета
алтайский: алтайского
привлекаться: привлекавшиеся
административный: административной
ответственность: ответственности
штраф: штраф
правонарушитель: правонарушителя
исходный: исходный
знак: знак знаках
приобрести: приобрёл приобрести
привычный: привычный
горноалтаец: горноалтайцев
авиакомпания: авиакомпании
рейс: рейс рейса
борт: борту бортов
произнести: произнеся
всевышний: всевышний
майкоп: майкоп
ящэнэрэ: ящэнэрэ
тыщылащэрэр: тыщылащэрэр
лингвистический: лингвистических
амстердам: амстердама
нью: нью
йорк: йорк йорка
недостаточный: недостаточного
судный: судна
авиационный: авиационных
авиалайнер: авиалайнеров
совершать: совершающих
час: часов часа
воздух: воздухе воздуха
грамм: граммов грамма
вылет: вылетом вылеты вылета
предотвратить: предотвратили
неизбежный: неизбежную
катастрофа: катастрофу катастрофа
атлантика: атлантику
пилот: пилоты пилотом
нервничать: нервничают
курить: курят
персонал: персонал персонала
долететь: долетели
тяжело: тяжело
смущать: смущают смущать
выдать: выдать
она: неё
зелёный: зелёный
чай: чай
прокомментировать: прокомментировал
авиаслужба: авиаслужбы
камилла: камилла
гандерхахинг: гандерхахинг
злополучный: злополучного
пересадить: пересадили
проводиться: проводится проводиться
экипаж: экипаж
отстранить: отстранён
обязывать: обязывающий
прямой: прямой прямые
доступность: доступности
аптечка: аптечку
индекс: индекс индекса
ценность: ценности
задуматься: задумался задумались задумайтесь
блокчейн: блокчейне
гурбангул: гурбангулы
бердымухамед: бердымухамедов
туркменистан: туркменистана
внедрение: внедрении
индивидуальный: индивидуальных индивидуальном
рейтинг: рейтингов рейтинг рейтинга рейтинги
еврокомиссия: еврокомиссии
адекватно: адекватно
заслуга: заслугам
распределять: распределять
ключевой: ключевых ключевым
ценный: ценна
априори: априори
стартовый: стартовые
балл: баллы
автор: автор
евродепутат: евродепутат
авигдор: авигдор
ландсберг: ландсберг
распределяться: распределяться
лояльность: лояльности
рассчитываться: рассчитываться
общий: общем общей
шкала: шкале шкала
угнести: угнетенными
преследовать: преследуемыми
лгбт: лгбт
беженец: беженцы
мигрант: мигрантов
холокост: холокоста
родство: родства
борец: борцы
убежище: убежище
отниматься: отниматься
угнетать: угнетающей угнетающего
сторонник: сторонников
ультра: ультра
правый: правых
популистский: популистских
движение: движения
введение: введение
ес: ес
италия: италии
маттео: маттео
сальвини: сальвини
постараться: постарается
максимально: максимально
саботировать: саботировать
минимум: минимум
недоработать: недоработан
максимум: максимум
нацизм: нацизм нацизма
получаться: получается получалось
наиболее: наиболее
ценить: ценимым
гей: гей геев
еврей: евреи
навязать: навязать
критерий: критерии
нацист: нацистами нацисты
некорректный: некорректные
оскорбительный: оскорбительны
черта: чертой
нормальный: нормальное нормальный
казаться: кажется
наоборот: наоборот
строчка: строчки
непонятно: непонятно
господин: господин господина
ровный: ровным
участница: участниц
млрд: млрд
водка: водке водка водки водку
татарский: татарская
тесло: тесла
готовый: готов готовы
высота: высоты
василий: василий
пякина: пякин
камаз: камаза
создание: создание создании
выполнять: выполнять выполняют выполняет выполнял
хранилище: хранилища
стратегический: стратегических стратегические
алкогольный: алкогольных
напиток: напитков
горячительный: горячительного
отдельный: отдельных
местность: местности местность
отдалить: отдалённых
печально: печально
обеспечить: обеспечены обеспечить
самогоноварение: самогоноварением
либо: либо
аптечный: аптечные
настойка: настойки
пять: пять пяти
деревня: деревне
хутор: хуторе
железнодорожный: железнодорожной
подвезти: подвезём
обойтись: обойдётся обошлось
акционерный: акционерное
росспиртпром: росспиртпром
вгик: вгик
видеоблогер: видеоблогеров
всякий: всякого всякие
законность: законности
либерал: либералы
демократ: демократы
жириновский: жириновский
лдпр: лдпр
институт: института институтов институт
кинематография: кинематографии
герасимов: герасимова
видеоблогинга: видеоблогинга
профессиональный: профессиональных профессиональный профессиональным
кадр: кадров
искусство: искусство
динамично: динамично
меняться: меняется
отражение: отражение
смена: смену смены
театр: театра
прийти: пришёл пришла придёт
передовой: передовой
кино: кино
успешно: успешно
сериал: сериал
однообразный: однообразным
влог: влоги
блогер: блогеров блогера
здорово: здорово
молодёжь: молодёжь молодёжи
развивать: развивает
искать: ищет
профессия: профессии профессией
верный: вернее
блогинга: блогинг
немедленно: немедленно
упущение: упущение
улучшить: улучшить
видеоролик: видеороликов
выгодно: выгодно
ректор: ректор
малышев: малышев
поведать: поведал
преподавательский: преподавательском
делиться: делиться
навык: навыками
иван: иван
гай: гай
саша: саша
спилберг: спилберг
галковский: галковская
амиран: амиран
сардар: сардаров
канал: канала
дневник: дневник
хач: хача
баженов: баженов
бот: бот боту
солженицын: солженицын солженицына
великий: великими великий великому великих величайших великой
изобретатель: изобретателями изобретатель изобретателя
харуто: харуто
тагава: тагава
приступить: приступил
обсуждать: обсуждающий
критиковать: критикующий
схожесть: схожести схожесть
позиция: позиции позицию
известный: известным известных известна известного известными
писатель: писатель
нобелевский: нобелевской нобелевского нобелевском нобелевскими
уметь: умеет
самообучаться: самообучаться
чтение: чтения чтении
новостной: новостных
аналитический: аналитических
формулировать: формулировать
так: т
оппозиционный: оппозиционную
прочесть: прочёл прочесть
матрёнин: матрёнин
двор: двор
ощущать: ощущал
определённый: определённую определённых
духовный: духовную
близость: близости
похожий: похожим похож
многий: многих
проявление: проявлениях проявлением
возникнуть: возникла
мысль: мысль мысли
отдать: отдать
дань: дань
уважение: уважения
публицист: публицисту
применить: применить
журналистика: журналистике журналистика журналистики
диссидент: диссидента
идеолог: идеолог
алексей: алексей
венедиктов: венедиктов
зорить: зорить
светлость: светлость
главица: главицы
гладость: гладость
заблокировать: заблокировал заблокирована
дрезденский: дрезденской
картинный: картинной
галерея: галереи галерее
изображение: изображение изображением
обнажённый: обнажённого
обида: обиде
скрипаль: скрипаль
лорд: лордов
великобритания: великобритания
передавать: передаёт
цензор: цензоров
спать: спящая
венера: венера венеры
перо: пера
итальянский: итальянских
художник: художника
джорджон: джорджоне
марк: марка
цукерберг: цукерберг
заретушировать: заретушировать
нагой: нагую
чёрный: чёрный чёрного чёрных
квадратик: квадратиками
дрезден: дрездене
счесть: сочли
предложение: предложение
неприемлемый: неприемлемым
ответственно: ответственно
просить: просил
отредактировать: отредактировать
полотно: полотна полотно
испортить: испортить испорчена испорчен
уникальный: уникальный
собрание: собрание
живопись: живописи
фейсбук: фейсбуком
сметь: смеет
указывать: указывать
обязательно: обязательно
вычислимый: вычислим
возмутиться: возмутился
бернард: бернард
маац: маац
стоить: стоит
путать: путать
извращение: извращениями
единый: единый единого единую един
чётко: чётко
прописать: прописаны
удивлять: удивляет
твориться: творятся
рассадник: рассадник
разврат: разврата разврате
опуститься: опустится опустившегося
претензия: претензии
эстонец: эстонец эстонцев эстонцы
наградить: наградят наградить награждены
медаль: медалью медали медалей
ти: ти
сверстник: сверстники сверстниками
погрязнуть: погрязла
фаста: фаст
фуд: фуде
физика: физика физики
маск: маск
кохтлый: кохтла
яров: ярве
тармо: тармо
тобрелутс: тобрелутса тобрелутс
звание: званием звание
повод: поводом
местный: местных местные
литературный: литературные
земляк: земляка земляку
освоить: освоившим освоить
роман: романа
лев: льва
толстой: толстого
прочтение: прочтение
эпопея: эпопеи
классика: классика
уйти: ушло ушёл
сложность: сложность
произведение: произведения
том: томов
эстонский: эстонский эстонской эстонских
зря: зря
соотечественник: соотечественников
осилить: осилил
хотя: хотя
дополнительно: дополнительно
торопиться: торопиться торопимся
спешить: спеша
атмосфера: атмосферой
перипетия: перипетиями
шедевр: шедевра
возникать: возникали возникало
лишиться: лишился
смутить: смутило
награда: награду
триумфатор: триумфатора триумфаторов триумфаторами
каренин: каренина
телесериал: телесериала
обвинить: обвинил обвинили
американец: американцев американцам американцы
плагиат: плагиате
частица: частицы
продюсер: продюсер
рихтер: рихтер
мелкумов: мелкумов
адаптировать: адаптировали
экранный: экранное
кинорынок: кинорынок
хаус: хаус
билли: билли
включить: включён
телевизор: телевизор
хью: хью
лори: лори
пародировать: пародирует
лёша: лёшу лёши
серебряков: серебрякова
обидеться: обиделся
понравиться: понравился понравилось
подавать: подавать
жалко: жалко
дарить: дарить дарю
контент: контент контента
востребовать: востребован
комментарий: комментариях комментарий
дмитрий: дмитрия дмитрий
троицкий: троицкий
счастливый: счастливы
серёга: серёга
фигня: фигня
замечательный: замечательный
точить: точь
передрать: передрали
женатый: женаты
самодельный: самодельного
кофе: кофе
копь: копи
лювак: лювак
ценообразование: ценообразование
гибкий: гибким
электросталь: электросталь электростали
сорокин: сорокин сорокина
марка: марки
подозрение: подозрение подозрением подозрения
оригинальный: оригинальный
производиться: производится
нетрадиционный: нетрадиционным
способ: способ способов
кофейный: кофейные
зерно: зёрна
поедаться: поедаются
малайский: малайскими
куница: куницами куниц
мусанга: мусангами
извлекаться: извлекаются
полупереварить: полупереваренном
фермент: ферментов
горький: горький
сорт: сорта
подмосковье: подмосковья подмосковье
воспроизвести: воспроизвёл
мусанг: мусангов
проживать: проживает проживающими
необыкновенный: необыкновенный
москвич: москвич
азиатский: азиатского азиатской
изготовление: изготовлении изготовление
контрафактный: контрафактной
санитарный: санитарных
сертификат: сертификатов
богема: богема
сворачиваться: сворачиваться
узнать: узнать узнав узнайте
саннадзор: саннадзор
рассчитывать: рассчитывает рассчитывают рассчитывать
закрыть: закрыть закрыли
пермь: перми
завершиться: завершилось завершилась
задержка: задержками задержкой
пермский: пермский
новоиспечённый: новоиспеченных
специальность: специальности
интеллектуальный: интеллектуальной
элита: элиты
ребята: ребята
приёмный: приемную
комиссия: комиссии комиссия
аттестат: аттестатами
неблагополучный: неблагополучных
фетальный: фетальным
коэффициент: коэффициентом
анализировать: анализировать
багаж: багаже
эфир: эфире
кафедра: кафедре кафедрой
идеально: идеально
морально: морально
заведовать: заведующий
абашева: абашев
проявить: проявили проявила проявят
предполагать: предполагаемый предполагаемая предполагал
карьерный: карьерный
перспектива: перспективу
беспристрастный: беспристрастного
обозрение: обозрения
ношение: ношением ношение
хиджаб: хиджаба хиджаб хиджабе
девочка: девочек
украсть: украсть
чип: чип
рука: руки руках
юлия: юлия
клиентка: клиентка
себрбанка: себрбанка
лондон: лондоне
школьница: школьниц школьница
дресс: дресс
код: кода код
подчёркивать: подчёркивают подчёркивает подчёркиваем подчеркивают
необходимость: необходимость необходимости
стандарт: стандартов стандартам
одежда: одежде
ученица: учениц ученица
независимо: независимо
национальность: национальности
установленный: установленного
допускаться: допускаться
отчисление: отчисления
современный: современная современного современное современный современным современные
целомудренный: целомудренной
выставлять: выставлять
напоказ: напоказ
приучать: приучать
зрелый: зрелом
необратимый: необратимым
зулия: зулия
хадли: хадли
удобно: удобно
носить: ношу носишь носить
переодеваться: переодеваться
целый: целый целую
малия: малия
халик: халик
поначалу: поначалу
привыкнуть: привыкнуть привыкли
показаться: показался
трендов: трендовым
джессика: джессика
пейт: пейт
положительно: положительно
новшество: новшестве новшество
высказаться: высказались
единение: единение
этнический: этнических
порекомендовать: порекомендовали
распространить: распространить распространённой
нововведение: нововведение
вена: вене
выпустить: выпустит выпустить
фюрер: фюрера
предназначить: предназначенной
несуществующий: несуществующей
юнгфольк: юнгфольк
рассказываться: рассказывается
нацистский: нацистский
форзац: форзаце
четверостишие: четверостишие
конфета: конфетой
щека: щекой
нация: нацию
взмахивать: взмахивал
повествование: повествование
стих: стихи
приключение: приключениях
проиллюстрировать: проиллюстрирована
исторически: исторически
рукописный: рукописные рукописный
версия: версии
утерять: утеряны
чудо: чудо
юноша: юноша
разбирать: разбирал
чердак: чердак
прадедушка: прадедушки
заинтересовать: заинтересовать заинтересовал
типографский: типографские
клише: клише
практически: практически
эталон: эталон
недоставать: недостающих
вчера: вчера
запустить: запустили
австриец: австрийцам
представиться: представилась представился
прадед: прадеды прадеда
продолжить: продолжить продолжим продолжат
прервать: прерванное
подумать: подумали подумал
катасон: катасонов
водолаз: водолаз
организатор: организаторы
генетически: генетически
модифицированный: модифицированных модифицированным
недобросовестный: недобросовестной
конкуренция: конкуренции
массировать: массированной
тоталитарный: тоталитарных
сложиться: сложилось
отрицательный: отрицательное
посмотреть: посмотреть
предубеждение: предубеждений
возрождаться: возрождающихся
юго: юго
фиксироваться: фиксируется
рекордный: рекордный
прирост: прирост
наблюдать: наблюдаем наблюдали наблюдать
демографический: демографический демографическую
мало: мало
потреблять: потребляют
есть: едят ел
вредоносный: вредоносную
органика: органику
столетие: столетия
угроза: угрозу
применяться: применяющихся применяются применяться
пестицид: пестицидов
неконтролируемый: неконтролируемых
радиационный: радиационной
селекция: селекции
переосмыслить: переосмыслить
особенно: особенно
беларусь: беларуси
заинтересованный: заинтересованные
герш: герш
либерманна: либерманн
лекция: лекций
волонтёр: волонтёры
подарить: подарил подарить подарен
буклет: буклеты
угостить: угостят
фирменный: фирменными фирменное
шведский: шведских шведской
стол: столах
подчеркнуть: подчеркнули
поколение: поколение
сокрушить: сокрушит
мракобесный: мракобесные
законодательный: законодательное
ограничение: ограничение ограничениям ограничении
улан: улан
удэ: удэ
убор: уборов уборам
фольга: фольги
набоков: набоков
шмелёв: шмелёв
слушать: слушать
утро: утрам
понедельник: понедельник
база: базе
нии: нии
кгб: кгб
научно: научно
исследовательский: исследовательская исследовательских исследовательский
клинический: клинической
гериатрия: гериатрии
биотехнология: биотехнологий
заводский: заводской
цех: цех
бурятский: бурятских
алюминиевый: алюминиевая алюминиевого
отражать: отражать
электромагнитный: электромагнитные
излучение: излучения
податливый: податлива
лошадь: лошадей лошадями
каска: каски
шляпа: шляпы
берет: береты
значительный: значительными
защитный: защитными
пагубный: пагубного
волна: волн
исходящий: исходящих
кровоснабжение: кровоснабжение
нервный: нервную
снижать: снижает
риск: риск
инсульт: инсульта
простатит: простатита
шизофрения: шизофрении
ветряный: ветряной
оспа: оспы
гарантировать: гарантирует гарантирующего
приятный: приятные приятных
сон: сны
валерий: валерий
андропкин: андропкин
опробовать: опробовали опробован
стратегически: стратегически
культурно: культурно
спортивный: спортивной спортивными
кирпич: кирпич
упасть: упал упала упадёт
бурятия: бурятии
случаться: случается
довольно: довольно
редко: редко
заказывать: заказывать
строительный: строительной строительных
шахмурат: шахмуратов
заказать: заказало заказать
появление: появление
сдача: сдачи сдаче
егэ: егэ
грамматический: грамматическими грамматические
зачистить: зачистила
письменный: письменные письменного
приднестровский: приднестровском
лингвый: лингво
омбудсмен: омбудсмен
рута: рута
даускайт: даускайте
сдавать: сдававших
написание: написании написание
просвещение: просвещения
кравцов: кравцов
экзамен: экзамене
неправильный: неправильных неправильного
преобладать: преобладают
рассия: рассия
расий: расия
роиссь: роисся
полагать: полагали полагаю полагает
детальный: детальнее
изучать: изучать изучают
грамматика: грамматику
пунктуация: пунктуацию
казус: казус казусов
настаивать: настаивать
значительно: значительно
ошибаться: ошибались
ленинградский: ленинградской
смоленский: смоленской
грамотный: грамотными
якутия: якутии
карачаево: карачаево
черкесия: черкесии
лотерея: лотерея
учредить: учредила учреждённая учреждённого
приз: приз приза
ночь: ночь
оксюморон: оксюморон
расцвет: расцвета
победа: победе победа победы
ренессанс: ренессанса
дюков: дюков
привлечение: привлечения
работница: работницей работницы
сфера: сферы
секс: секс
лотерейный: лотерейной лотерейного
шаг: шаг
азартный: азартной
игра: игры игру игр
численность: численность
уменьшиться: уменьшились уменьшился
выигрыш: выигрышей
отток: отток
покупатель: покупателей
билет: билетов билетами
преминуть: преминули
воспользовиться: воспользоватся
конкурент: конкуренты
выигрывать: выигрывать выигрываешь
ден: ден
бергсм: бергсма
круто: круто
выиграть: выиграть
джекпот: джекпот
красивый: красивой красивая красивых
одобрить: одобрил
исполнять: исполнять
распространитель: распространители
успешность: успешности
индустрия: индустрии
рассматривать: рассматривают рассматриваем рассматриваю
меньшинство: меньшинств
распорядиться: распорядился
раздавить: раздавить раздавите
президентский: президентская президентской
внимательный: внимательного
негодование: негодование
стенограмма: стенограмме
никуда: никуда
годиться: годится
зараза: заразы зараза
разведка: разведка
наверное: наверное
бесполезный: бесполезны бесполезную
профиль: профилях
госдепартамент: госдепартамента
химтрейл: химтрейлов
безопасность: безопасности
картинка: картинок картинки
деградировать: деградировавшие
этна: этна
джонс: джонс
ответ: ответа
запрос: запрос
японский: японского японских японские японским
наока: наоки
окады: окады
искусственный: искусственный
экология: экологии
департамент: департамента
авиабезопасность: авиабезопасности
видимый: видимые
след: следы
укладываться: укладывающиеся
естественный: естественных естественные
объяснение: объяснений
окада: окада
воспользоваться: воспользовался
заснять: заснять
расстояние: расстояния расстояние
выдвигаться: выдвигающееся
гражданский: гражданского
распылять: распыляемые
попробовать: попробовал попробовали
досмотреть: досмотреть
приземление: приземления
найтись: нашлось
отснять: отснять
крепление: крепления
показание: показания
стюардесса: стюардессы стюардессой стюардесса
европеоидный: европеоидной
наружность: наружности
разговаривать: разговаривавших
японски: японски
забирать: забирали забирают
вскоре: вскоре
разыскать: разыскать
уточнение: уточнения
деталь: деталей
разговор: разговора разговоре
уволить: уволили
удалить: удалили
личный: личное личная личном личный
встретить: встретил
встретиться: встретились
испугаться: испугалась
знакомый: знакомы
чудовищно: чудовищно
искажённый: искажён
странный: странные странных
звук: звуки
храниться: хранилась хранится
формат: формате
плёнка: плёнка
деформироваться: деформироваться
внешний: внешних
файл: файл файлы
аудио: аудио
сопоставить: сопоставив
наблюдение: наблюдения
аэропорт: аэропорта аэропорту аэропортах
удостовериться: удостоверился
представительство: представительства
монтировать: монтируют
равномерно: равномерно
опылять: опыляли
густонаселённый: густонаселённых
район: районов районе
япония: японии
распылитель: распылители
оперативно: оперативно
вывозить: вывозят
внутренний: внутренних внутренней
абсолютный: абсолютной
уверенность: уверенностью
уважаемый: уважаемого
окаду: окаду
появляться: появляющихся появляются появляться
упоминать: упоминаете
ваш: вашем
вследствие: вследствие
аппаратура: аппаратура
договор: договорами
лайнер: лайнеров
сбор: сбору
персонифицировать: персонифицированной
изыскание: изысканий
воздухоплавание: воздухоплавания
достигать: достигают
поверхность: поверхности поверхность
конструкция: конструкция
засекретить: засекречены
задокументированный: задокументированные
подтверждать: подтверждают
проводить: проводимых проводивший проводили
блог: блоге
отсканировать: отсканированную
наказывать: наказывать
самовольный: самовольное
необъяснимый: необъяснимая
бессонница: бессонница
вкупе: вкупе
концентрация: концентрацией
уехать: уехал
разглашать: разглашает
подозрительный: подозрительные
симптом: симптомы
кешиктен: кешиктенами
попытка: попытке
угнать: угнать
зоопарк: зоопарка
вторник: вторник
увд: увд
цао: цао
гу: гу
вооружённый: вооруженных
антикварный: антикварным
оружие: оружием
заложник: заложники заложника
преступник: преступники преступников
коридор: коридор
отход: отхода
оперативник: оперативники оперативников
переговоры: переговоры
преступный: преступной
группировка: группировки
темуджина: темуджин
родиться: родившийся
седло: седле
злоумышленник: злоумышленника злоумышленник
нелегальный: нелегальными
жилой: жилых
отпустить: отпустили отпустил отпустить
сдаться: сдались
экстрадиция: экстрадиции
сбежать: сбежавший
психоневрологический: психоневрологического
диспансер: диспансера
уроженец: уроженец
бакбермурат: бакбермурат
януроглий: януроглиев
гастарбайтер: гастарбайтеров
произвести: произведёт
ранг: ранг
предать: преданных
кешиктенов*: кешиктенов*
повести: поведет
неслыханный: неслыханным
богатство: богатствам
ограбить: ограбил
магазин: магазина
антиквариат: антиквариата антиквариат
направиться: направился
бронина: бронин
возвратить: возвращен возвращён возвращены
*кешикесть: *кешиктены
гвардия: гвардия
хан: ханов
пешеходный: пешеходного
метро: метро
метрополитен: метрополитен метрополитена
брифинг: брифинге
собянин: собянин
подземка: подземка
дублировать: дублировать
рельсовый: рельсового
охватить: охватит
близлежащий: близлежащие
населённый: населённые
совместить: совмещено
тюмень: тюмени
отклик: откликов
реализовать: реализовать реализуем
задумать: задуманное
суть: сути
нигде: нигде
платформа: платформы
рельс: рельсы
поезд: поезда
депо: депо
дешёвый: дешевле
удобный: удобным удобной удобна
тоннель: тоннелях
играть: играть играет
музыка: музыка музыки музыку
демонстрироваться: демонстрироваться
торговый: торговых торговому
комфортно: комфортно
современно: современно
внести: внесла внесены внесёт
муниципалитет: муниципалитет
норвежский: норвежского
освободить: освободит освободить
уплата: уплаты
налог: налогов
переселенец: переселенцев переселенцы
болеть: болеете болеть
рано: рано
умирать: умираете
отрава: отраву
богомерзкий: богомерзких
микроволновка: микроволновках
газовый: газовых
плита: плитах
придумать: придуманных придумали придумать
дьявол: дьяволом
тромс: тромсе
восходящий: восходящей
гражданство: гражданства гражданство
норвегия: норвегии
непривычный: непривычной
излишний: излишне
эгоистичный: эгоистичный
заводить: заводить
вовсе: вовсе
прибегнуть: прибегнуть
юг: юга юг
приветствоваться: приветствуются
часто: часто
трое: троих
четверо: четверых
хотеться: хотелось
сохранить: сохранить
привлечь: привлекут
зухра: зухра
иверсный: иверсен
налоговый: налоговыми
образоваться: образуется
налогообложение: налогообложения
покрыть: покрыт
повышение: повышения
ставка: ставки
фолкнуть: фолк
фестиваль: фестивале
ирландия: ирландии
исполнить: исполнили
гимн: гимн гимном
ангел: ангел
проехать: проедет
грузовик: грузовике
ванг: ванга
андрей: андрей
ренье: ренье
дублин: дублине
люфтваффа: люфтваффе
войско: войска
рейх: рейха
прозвучать: прозвучит прозвучал
сыграть: сыграла сыграть
композиция: композицию композицией
ирландский: ирландская ирландской ирландский
возбуждение: возбуждением
реабилитация: реабилитация реабилитации
сперва: сперва
ред: ред
республиканский: республиканской
осознать: осознали
возмутительный: возмутительный
вероятность: вероятности
суровый: сурового
наказание: наказания
следователь: следователь
пэдди: пэдди
пэддингтон: пэддингтон
музыкант: музыканты
предосудительный: предосудительного
поддерживать: поддерживаем поддерживают
вне: вне
мелодичный: мелодичная мелодичным
невзирая: невзирая
маргинал: маргиналов
кстати: кстати
подпевать: подпевала
фронтмен: фронтмен
коллектив: коллектива коллективом
бобиня: бобини
общественный: общественные общественных
активист: активисты активист
следствие: следствию
указанный: указанная
старинный: старинной
приравнивание: приравнивание
француз: французов французы
неонацист: неонацистам
минздрав: минздрав минздрава
категория: категории
отсталость: отсталости
упрощённый: упрощённой
разослать: разослало
методический: методические
ускоренный: ускоренной
обследование: обследования
участвовать: участвовать
пирамида: пирамиде
убеждённый: убеждён
память: памяти память
фраза: фраз
даллеса: даллеса
эгрегор: эгрегор
глобальный: глобальный
предиктор: предиктор
чакра: чакра
уверенный: уверен
придумывать: придумывает придумывать
окружающие: окружающим
истинный: истинные истинную
еврейский: еврейские еврейское
фамилия: фамилию
терпеть: терпит
впадать: впадает
отрицание: отрицание
ступор: ступор
опасаться: опасается
микроволновый: микроволновые
печь: печи
объяснять: объясняет
радиоактивный: радиоактивными
стирать: стирают
молекула: молекул
экспресс: экспресс
диагностирование: диагностирования
полусотня: полусотни
задать: задать
набрать: набрал набрать
выдаваться: выдаётся
уведомляться: уведомляются
родственник: родственники
превысить: превысил
опасный: опасным опасных
отзыв: отзывам
среднестатистический: среднестатистический
нод: нод
набирать: набирает
теория: теории
заговор: заговора
обращать: обращают
выше: выше
среднее: среднего
активность: активностью
зависимость: зависимости
оппозиция: оппозицию
прошедшее: прошедшем
дума: думы
ольга: ольги ольга
васильев: васильевой
инновационный: инновационный инновационное
предусматривать: предусматривает
принцип: принципу принципе
очный: очного
располагаться: располагаться располагалось располагается
училище: училищ
колледж: колледжей
университетский: университетская университетскую
громоздкий: громоздкая
выслушивать: выслушивать
диплом: дипломами диплома
полезный: полезными полезное
необязательно: необязательно
математика: математику
философия: философию
приходить: приходить приходят
субботник: субботниках
залог: залогом
трудоустройство: трудоустройство
вырасти: вырастет вырос
торопиловый: торопилово
грузчик: грузчик
складывать: складывает
зато: зато
убить: убить
удар: ударом
расположить: расположенное расположенном
ивангородской: ивангородском
российско: российско
граница: границей
пожелание: пожеланий
состоять: состоящего
наследие: наследия
социализм: социализма
бороться: бороться
например: например
ворошилов: ворошилова
партизан: партизан
ветемаа: ветемаа
аккуратно: аккуратно
демонтировать: демонтировали
выручить: вырученные
соорудить: соорудили
лежачий: лежачий
малое: малым
референдум: референдум
сельсовет: сельсовета
урмас: урмас
тахта: тахт
общесельский: общесельский
переименование: переименованию
рассмотрение: рассмотрение
общественность: общественности
неспешилово: неспешилово
нарва: нарва
квадрат: квадрат квадрата
малевич: малевича малевичем малевич
экспонироваться: экспонировался
третьяковский: третьяковской
вверх: вверх
нога: ногами
держава: держава
виктор: виктор
шендерович: шендерович
казимир: казимира
ракурс: ракурса
перепутать: перепутали
верх: верх
низ: низ
искусствовед: искусствовед искусствоведа
специализироваться: специализирующийся
творчество: творчестве творчества творчество
авангардист: авангардиста
зинаида: зинаида
роговский: роговская роговской
меерсон: меерсон
париж: париже
третьяковка: третьяковку
висеть: висела
свидетельствовать: свидетельствует
невидимый: невидимой
обыватель: обывателя
микроскопический: микроскопическая
казя: казя
внизу: внизу
ласково: ласково
гений: гения
реставрация: реставрация
оплошность: оплошность
круг: круг
бдительный: бдительному
взор: взору
гусев: гусева
неточность: неточность неточности
поклонник: поклонникам
положение: положение
подлинник: подлинник
сантиметр: сантиметров
изобразить: изображён
впоследствии: впоследствии
авторский: авторских
повторение: повторений
коллекция: коллекциях
эрмитаж: эрмитажа
прихожанка: прихожанке
неотпустить: неотпущенные
терминал: терминал терминалами
придерживаться: придерживаются придерживающихся
предписание: предписаний предписания
брюква: брюкву
варлаа: варлаам
исповедальный: исповедальным исповедальный
радио: радио
жительница: жительница
казерот: казерты
джованна: джованна
джилли: джилли
зайти: зашёл
исповедь: исповеди
прощение: прощения
аппарат: аппарат
прегрешение: прегрешения
евро: евро
дьявольский: дьявольскую
столько: столько
грешница: грешницей
обворовать: обворовать
исповедать: исповедать
гордыня: гордыню
франциска: франциску
постановить: постановил
забрать: забрала забрать
ремонт: ремонт
усовершенствовать: усовершенствованной
небольшой: небольшой
ареццо: ареццо
подросток: подростки
отравиться: отравившиеся отравился
латышский: латышскими
шпрот: шпротами шпроты
выжить: выжили выжить
булка: булка
хрустнуть: хрустнет
возродиться: возродится
медицинский: медицинский медицинской
пенза: пензе
отделение: отделение отделения
реанимация: реанимации
интенсивный: интенсивной
терапия: терапии
больница: больницы
ботулизм: ботулизм ботулизма
двое: двое
отравление: отравления отравление
санкционный: санкционные
латвия: латвии
повышенный: повышенное повышенном
кровь: крови
вздутие: вздутие
живот: живота
сухость: сухость
рот: рту
глотание: глотании
смертельный: смертельным
токсин: токсином
подтвердиться: подтвердились
сознаться: сознался
консервы: консервы
вздутый: вздуты
усложнять: усложняла
интоксикация: интоксикация
тяжесть: тяжести
противоботулический: противоботулической
сыворотка: сыворотки
истечение: истечении
удивительный: удивительным удивительный
исцеление: исцеления
неизведанный: неизведанным
нейтрализовать: нейтрализовала
ботулотоксин: ботулотоксина
бессывороточный: бессывороточный
токсикоинфекция: токсикоинфекций
заместитель: заместитель
главное: главное
ларионов: ларионов
оказать: оказанной оказавший
экстренный: экстренной
инфекционный: инфекционного
ничто: ничто
угрожать: угрожает
избирать: избирать
кандидат: кандидатов
отрабатывать: отрабатываем
техасский: техасского
льюисвилл: льюисвилл
цвет: цветом цвету
кожа: кожи
расизм: расизма
аргументировать: аргументировать
выдвигать: выдвигали
джесси: джесси
джефферсон: джефферсон
оправдание: оправданием оправданий
прение: прений
полномочие: полномочий полномочиями
текущий: текущего
раса: расы
преследование: преследования
избиратель: избирателя
отмечаться: отмечается
реестр: реестра
атеист: атеистов
язычник: язычников
ехидно: ехидно
хихикать: хихикающими
олимпийка: олимпийки
улыбаться: улыбался
томас: томас
бах: бах
мокнуть: мок
заняться: занялись займётся
вера: вера
сведение: сведения
исповедовать: исповедующих
языческий: языческую языческих
религия: религию религии
радикальный: радикального
атеизм: атеизма
млн: млн
дотация: дотации
фгуп: фгуп
попадать: попадать
прибегать: прибегать
фигурант: фигуранты
истинность: истинность
переход: переходу
патриархат: патриархата
служитель: служителей
кадровый: кадровые
банковский: банковского
сектор: сектора
синодальный: синодального
протоиерей: протоиерея протоиерей
каганович: кагановича каганович
рассматриваться: рассматривается
добавление: добавления
молебен: молебен
виртуальный: виртуальную
свечка: свечку
скрытие: скрытию
удаление: удалению
тестовый: тестовом
утвердить: утверждённое утвердил
техзадание: техзадание
чёткий: чёткое
видение: видение
совмещение: совмещения
базовый: базовой
архитектура: архитектуры
приложение: приложения
разработчик: разработчики
закладывать: закладывают
сетевой: сетевого
взаимодействие: взаимодействия
квартал: квартале
селекторный: селекторном
совещание: совещании
гомофобный: гомофобные
петрарка: петрарка
лирический: лирических
сонет: сонетов сонета
возрождение: возрождения
франческо: франческо
литература: литературу
гомофобия: гомофобией
задаться: задалась
художественный: художественными художественный
ужаснуться: ужаснулась
насквозь: насквозь
пропитать: пропитано
топор: топором
травить: травят
нервно: нервно
паралитический: паралитическим
король: короля
душа: душу
плотский: плотские
утеха: утехи
возмутить: возмутил
лаура: лаура
сонм: сонм
неполноценный: неполноценными
урсула: урсула
шмидхоффера: шмидхоффер
толерантность: толерантности
дисциплина: дисциплине
проторенессанс: проторенессанса
средневековый: средневековую
поэзия: поэзию
музыкальный: музыкальную
екатеринбург: екатеринбурге
переделать: переделали
егор: егору егора егор
гайдар: гайдар
путь: путь пути
повреждать: повреждали
налепить: налепили
заранее: заранее
изготовить: изготовленную
полимерный: полимерного
придать: придала
клей: клей
раствориться: растворится
символичный: символичная
чудовищный: чудовищный
умалять: умаляем
важность: важность
выбросить: выбросил
выбить: выбил
почва: почву
комми: комми
уродливый: уродливой
десятка: десяток
установиться: установились
забывать: забывать
рывок: рывок
поблагодарить: поблагодарил
профинансировать: профинансировал
подъёмник: подъёмника
астрахань: астрахани
достать: достали
плыть: плывший
синагога: синагогу
дедушка: дедушка
ын: ын
областной: областном
поднять: поднят подняли
енотаевка: енотаевка енотаевку
сводка: сводках
мчс: мчс
стихийный: стихийного
бедствие: бедствия
затопить: затопило
унести: унесла
вниз: вниз
уплыть: уплывшую
утром: утром
патрулирование: патрулирования
моторный: моторной
лодка: лодке лодки
напарник: напарником
дежурство: дежурство
видный: видна
туловище: туловище
погрузить: погрузили погрузить
енотаевец: енотаевцы
утопленник: утопленника
вроде: вроде
декоммунизация: декоммунизации
везде: везде
долг: долг
паут: паутов
здание: здание здания
рейсовый: рейсовым
сургут: сургуте
ожирение: ожирением
дырявый: дырявых дырявые
ложка: ложек ложки ложками
призыв: призывы
соблюдать: соблюдать
ласточка: ласточка
цепель: цепель
главврач: главврач
психиатрический: психиатрической
кащенко: кащенко
борьба: борьбы
сургутский: сургутские сургутских
тандартный: тандартные
столовый: столовых
аккуратный: аккуратнее
утолять: утолять
отразиться: отразиться
относиться: относились
опаска: опаской
столовая: столовые столовую
прибор: приборы
петушок: петушками
клевать: клюют
зёрнышко: зёрнышко
перемена: перемене
усидчивый: усидчивее
урок: уроков
младший: младших
класс: классов классах
алевтина: алевтина
старшеклассник: старшеклассникам
видимо: видимо
острый: острую острые
обед: обеда
завуч: завуч
магаданов: магаданова
хант: ханты
мансийский: мансийского
автономный: автономного
округ: округа
окончание: окончанию окончание
грядущий: грядущего
кубанский: кубанского кубанским
филиал: филиал филиала
тель: тель
авив: авиве
торжественно: торжественно
хапоэль: хапоэль
гуляние: гуляниями
показательный: показательными
выступление: выступлениями выступление выступления
наездник: наездников
край: края
беер: беер
шева: шевы
атаман: атаман
израильский: израильской израильский
перебраться: перебрались
казак: казаков
обетованный: обетованной
удаль: удаль
внук: внукам внуки
зреть: зрел
назреть: назрел
авивский: авивский
иерусалимский: иерусалимский
семён: семён
ашкенази: ашкенази
кубань: кубань
вольный: вольный
казацкий: казацкое
чуждый: чуждо
абрамович: абрамович
шашка: шашку
напутственный: напутственным
долуда: долуда
дружина: дружины
наделить: наделённые
досматривать: досматривать
смартфон: смартфоны
болтонский: болтонского
дебютант: дебютантами
совместный: совместной совместные совместная
ликвидация: ликвидации
сельхозпроизводство: сельхозпроизводстве
засев: засевом
затратный: затратно
активно: активно
отпрыск: отпрыски
предпочитать: предпочитают
добрый: добрые
вспомнить: вспомнил вспомнить
хиттон: хиттон
приучение: приучения
интеллектуал: интеллектуалов
нацелить: нацеленная
пропасть: пропасти
британец: британцами британцам британец
обучаться: обучающимися
насколько: насколько
узнавать: узнают
джекка: джекки
образовательный: образовательного образовательную образовательных
туманный: туманного
альбион: альбиона
сельхозорганизатор: сельхозорганизатора
принудительный: принудительное
вовлечение: вовлечение
тушение: тушения
лесной: лесных
пожар: пожаров
шаман: шаманов шаманы
отчитываться: отчитываюсь
мама: мамой
покупка: покупках покупку
чарльз: чарльз
принц: принц
уэльский: уэльский
магический: магических
саха: саха
павел: павел
гарин: гарин гарина
якутский: якутских
кормление: кормления
огонь: огня
пламя: пламени
скармливать: скармливают
задобрить: задобрить
божество: божество
пожароопасный: пожароопасную
обстановка: обстановку
духовенство: духовенства
вертолёт: вертолёта
эффективность: эффективность
вдвое: вдвое
региональный: регионального
трудоустроить: трудоустроены
отряд: отрядов
поджечь: поджечь
спецучасток: спецучасток
хвойный: хвойного
лес: леса
гектар: гектаров
тренировка: тренировок
чм: чм
сборная: сборной
петушиный: петушиный петушиного
половец: половцы
печенег: печенеги
предок: предки
азербайджанец: азербайджанцев
маргарита: маргарита
симоньян: симоньян
редактор: редактор
устроить: устроить устроивших
символ: символом
петух: петухи
гордость: гордость
мужественный: мужественными
придавать: придают
напутствовать: напутствуют
жилить: жиль
пригласить: пригласил пригласили
отведать: отведать
блюдо: блюдо
изумительный: изумительный изумительной
суп: суп супа
стефан: стефан
травер: травер
накормить: накормили
изнурительный: изнурительного
средиземный: средиземному
море: морю
вкусно: вкусно
вратарь: вратарь
стив: стив
манданда: манданда
футболист: футболистов футболисту футболисты
именной: именными
турнир: турнира
обыграть: обыгравшая обыграл
хорватия: хорватии
возвращать: возвращать
руководить: руководил
джастин: джастин
трюдо: трюдо
депутат: депутаты депутат
урал: урала
вопреки: вопреки
фифа: фифа
атрибутика: атрибутику
цивилизовать: цивилизованного
убедиться: убедились убедился
никакой: никаких
извинить: извините
выражение: выражение
совка: совка
нелепый: нелепым
звезда: звёзд
серп: серпов
молотов: молотов
миг: миг
опозориться: опозоримся
поделить: поделить
горсовет: горсовета
аксельрод: аксельродов
достигнутый: достигнутым
договорённость: договорённостям
скрыть: скрыть скрыли
убрать: убрать
квалифицировать: квалифицировали квалифицированным
элемент: элементов
поместить: помещены
куба: кубы
грань: гранях
размещаться: размещалась
временной: временные
губернатор: губернатору губернаторов
калоша: калоши
правительственный: правительственной
отдельно: отдельно
бочаров: бочаров
вица: вице
премьер: премьер
дождь: дожди
поплыть: поплыл
иванович: иванович
подарочек: подарочек
передвигаться: передвигаться
леонтиевич: леонтьевич
поплавать: поплавает
гавань: гавань
болельщик: болельщиков болельщикам
подвозить: подвозить
планироваться: планировалось
следить: следить
премьера: премьера
обувь: обувь
утопить: утопил
байкал: байкале
мяч: мяч
миллениал: миллениалов
экологичный: экологичное экологичной
транспортный: транспортное
зарядка: зарядки зарядок
новинка: новинка новинки
мускульный: мускульная
тяга: тяга
водитель: водителя
уточнить: уточнили
велотренажёр: велотренажёр
возить: возит
заправочный: заправочных
утомительный: утомительных
аккумулятор: аккумулятора
вонь: вони
сплав: сплава
колесо: колёсами
педаль: педалями
одновременно: одновременно
заботиться: заботится заботившихся
бескомпромиссный: бескомпромиссный
презентация: презентация
пасть: пало
алтый: алто
инсайдер: инсайдеров
предзаказ: предзаказ
передвижение: передвижения
комплектация: комплектации
интурист: интуристы
разъехаться: разъехались
саранск: саранске
прочёсываться: прочёсывается
прояснить: проясним
саранец: саранцы саранец
воспринять: восприняли восприняла
воодушевление: воодушевлением
беспокоиться: беспокоятся
сохранность: сохранность
вынужденный: вынужденного
честный: честный
негр: негр негром
детройт: детройт
довести: довели
полезть: полезли
саранка: саранка
галина: галина
дача: даче
комар: комары
закусать: закусали
португалец: португальцев
унылый: унылый
анкоридж: анкоридж
благополучный: благополучными
увольнение: увольнении
забастовка: забастовку
приобретение: приобретения
ювентус: ювентусом ювентус
нападать: нападающего нападавшего
реал: реала
криштиану: криштиану
роналда: роналду
генеральный: генеральный
автоконцерн: автоконцерна
серджио: серджио
маркионна: маркионне
португалия: португалии
лояльный: лояльных
именитый: именитому
еврокубок: еврокубков
лига: лигу
чемпион: чемпионов
купить: купили
знающий: знающего
добиваться: добивается
выясняться: выясняется
пожертвовать: пожертвовать
привезти: привезу
сюда: сюда
конвейер: конвейере
постоять: постоят
поболеть: поболеют
сброд: сброд сброда
нищий: нищие
деревенский: деревенские
португальский: португальского
форвард: форварда
мадридский: мадридского
туринский: туринский
потратить: потратил
взяться: возьмется
немногий: немногих
голодать: голодал
грета: грета
тунберг: тунберг
экологический: экологическая экологический
активистка: активисток активистка
конференция: конференции
учитывать: учитывая
сколько: сколько
становиться: становились
пророческий: пророческими
миссия: миссию
сегодняшний: сегодняшних
реалия: реалиям
приблизительно: приблизительно
возмужать: возмужать
опричник: опричника
сюжет: сюжета
плиоценовый: плиоценовый
фаллос: фаллос
геолог: геологе
алтай: алтай
обнаруживать: обнаруживать
подземный: подземный
арахнида: арахнидами
подконтрольный: подконтрольными
эфемерный: эфемерным
недра: недр
соткать: сотканным
воспоминание: воспоминаний
объединиться: объединившись
взрослый: взрослым
гомосексуальный: гомосексуальным гомосексуальной
потомственный: потомственным
литовский: литовским
боярин: боярином
юргенс: юргенсом
лукастас: лукастасом
бой: бой
нашествие: нашествию
выяснять: выясняет
кибернетический: кибернетического
перерождение: перерождения
параллельный: параллельная
печник: печнику
неназванный: неназванной
охранять: охраняющему
дворницкий: дворницкой
тайный: тайное
святилище: святилище
бахус: бахуса
персонаж: персонажи
герой: герои
хтонический: хтоническим
экстаз: экстазом
трансформация: трансформации
программист: программист
забыть: забыл
раскрутить: раскрутил
подписчик: подписчиков
юность: юности
формула: формулы
поверьте: поверьте
судьба: судьба судьбу
глубоко: глубоко
небезразличный: небезразлична
вселенский: вселенский
самарский: самарский
анастасиевич: анастасиевич
случайный: случайные случайную
добавлять: добавлять
фильтр: фильтр
цитата: цитату
удалённый: удаленный
сервер: сервер
паблик: паблика
племянница: племянницы
логин: логин
пароль: пароль
поверить: поверил
нуль: нуля
сырой: сырой сырым
закидывать: закидывал
бессмысленный: бессмысленные
удивление: удивление
заинтересоваться: заинтересовались заинтересовался
разница: разница
показывать: показывать
эффективно: эффективно
уставать: устаёт
олег: олег олега олегу
кашевар: кашеваров
администратор: администратором
насчитывать: насчитывает
повторить: повторить
шанс: шанс
подхватить: подхватить
вшить: вшей
железный: железные
дорога: дороги
свисток: свисток
арбитр: арбитра
венчать: венчающий
праздник: праздника
сочинский: сочинской
загреб: загреба
распивать: распивают
запивать: запивая
поражение: поражение поражения
любимец: любимцев
горе: горя
громить: громят
авто: авто
порция: порцию
эмоция: эмоций
доблесть: доблести
подопечный: подопечных подопечном
сенсеять: сенсея
черчесова: черчесова
гол: голах
итоговый: итоговом
распределение: распределении
непредвиденный: непредвиденными
различие: различиями
культурный: культурного культурной
ясно: ясно
выдворить: выдворенный
недопить: недопитую
бутылка: бутылку
виски: виски
успеть: успел
посольство: посольства
противный: противном
грозиться: грозился
бойкотировать: бойкотировать
далёкий: дальше
спикер: спикер
парламент: парламента
островной: островного
фиджи: фиджи
лайсениа: лайсениа
мбаниараманама: мбаниараманама
инаугурация: инаугурацию
островитянин: островитянин
путинский: путинском
шапито: шапито
рать: рать
насрать: насрать
чертаново: чертаново
бейсбольный: бейсбольные
битый: биты
самозащита: самозащиты
пугать: пугать
поликлиника: поликлиники
кой: кое
ограничить: ограничили ограничить
продажа: продажи
свинин: свинины
попросить: попросили попросить
диана: диана
шурыгин: шурыгина
согласиться: согласилась согласился
поработать: поработать
медсестра: медсестрой
незаменимый: незаменимый
маячок: маячки
слежение: слежения
выехать: выехавших
правда: правда
прибалтийский: прибалтийской
исландский: исландский
гундермурд: гундермурд
сигурдфлордбрадсный: сигурдфлордбрадсен
произносить: произносить
сочи: сочи
невнимательный: невнимательной
заставка: заставку
спасский: спасской
башня: башне
кремль: кремля
полумесяц: полумесяц
матч: матчи
извиняться: извиняться
любимый: любимую
лия: лию
меджидович: меджидовну
египет: египте
разгромный: разгромным
равнодущный: равнодущным
купюра: купюры
лик: ликом
студия: студия
тритэ: тритэ
очередной: очередной
спортивно: спортивно
тематика: тематику
интересно: интересно
сборный: сборные
швед: шведов
нижегородский: нижегородской
паз: паз
отправиться: отправится отправятся
швеция: швецию
поучиться: поучатся
проигрыш: проигрыша
виноватый: виноватым
сенегальский: сенегальский
колдун: колдун
хорват: хорватов
серебряный: серебряных
первенство: первенства
орден: орденом
геринг: геринга
иран: ирана
многое: многого
пределами…: пределами…
иранец: иранцы
ядерный: ядерных ядерный ядерная
подмосковный: подмосковной
дубна: дубне
извлечь: извлекли
пара: пару
скандал: скандалов
гостеприимный: гостеприимной
везти: везло
германец: германцам
целовать: целовал
мужик: мужик мужиками
трансгендер: трансгендер
пол: пола
достаться: досталось
обозвать: обозвал
афроамериканец: афроамериканец
поведение: поведением
родительский: родительский
комитет: комитет комитета комитете
питер: питер
мочить: мочи
нева: неве
стесняться: стесняться
фотографировать: фотографировать
тв: тв
выбежать: выбежали
ехать: едут
кубок: кубком
домой: домой
огород: огороды
боярышник: боярышника
настроить: настроенной настроены
продавщица: продавщице
нижний: нижнего
новгород: новгорода
прокалывать: прокалывала
презерватив: презервативы
генофонд: генофонд
сатана: сатаны
сатанизм: сатанизма
наравне: наравне
приятно: приятно
ощутить: ощутить ощутила
свежий: свежий
кедровый: кедровый
запах: запах
зульфия: зульфия
низамутдинов: низамутдинова
конституционный: конституционной
преподавание: преподавание
предмет: предмет предмета
воланд: воланда
сердюков: сердюкова сердюков
равноправие: равноправии
соблюдаться: соблюдается
нейтралитет: нейтралитете
минпросвещение: минпросвещения
предупреждать: предупреждал
разрешение: разрешения
гимназия: гимназия
формально: формально
мериться: мериться
понятно: понятно
паства: паствы
бэкграунд: бэкграунд
христианство: христианства
заканчиваться: заканчивается
открытый: открытом
заря: заре
регистрироваться: регистрировались
минюст: минюсте
формальный: формальных
отказать: отказать
экстремист: экстремисты
радикал: радикалы
проповедовать: проповедуем
идеология: идеологии идеологий
царь: царя
хранить: храни
империя: империи
дорожка: дорожки
отсылать: отсылающие
мелодия: мелодиям
сателлит: сателлитов
испания: испании
правление: правления
франсиско: франсиско
франко: франко
царский: царским царских
евросовет: евросовете
единогласно: единогласно
звучать: звучит
имперски: имперски
пробуждать: пробуждать
недопустимый: недопустимые
амбиция: амбиции
обсудить: обсудил
калинка: калинка
яблочко: яблочко
таки: таки
проповедь: проповеди
тщеславие: тщеславия
яхта: яхте
горнолыжный: горнолыжных
метрический: метрической
либерия: либерия
мьянма: мьянма
академия: академии
нурсултан: нурсултан
назарбаев: назарбаев
измерение: измерения
измеряться: измеряться
миля: милях
километр: километров
вес: вес
фунт: фунтах
килограмм: килограммов
температура: температура
градус: градусах
фаренгейт: фаренгейта
неудобный: неудобны
быт: быту
латиница: латиницу
казахстанский: казахстанский казахстанских
издать: изданы
автолюбитель: автолюбителей
числовой: числовые
значение: значения
дорожный: дорожных
рен: рен
подвиг: подвиг
анонсировать: анонсировал
анатолий: анатолия
начальник: начальника
имущественный: имущественного
мо: мо
евгения: евгении
анонс: анонсе
сложный: сложнейшую
реформирование: реформирования
преображение: преображения
скромный: скромный
невозможный: невозможное
подтянуть: подтянул
руина: руин
двадцать: двадцать
вперёд: вперед
миф: миф
коррупция: коррупции
оборонный: оборонном
происки: происки
блестящий: блестящая
спецоперация: спецоперация
прикрытие: прикрытию прикрытием
незамеченный: незамеченный
экран: экранах экране
диктор: диктор
ролик: ролике
эксперт: эксперта эксперт
простить: простили
стремительный: стремительное
превращение: превращение
полуразрушить: полуразрушенной
щелчок: щелчком
палец: пальцем
раскатать: раскатать
асфальт: асфальту асфальт
картонный: картонную
мощь: мощь
завеса: завесой завесу
тайна: тайны
поистине: поистине
неблагодарный: неблагодарную
отвести: отведено
некомпетентный: некомпетентных
коррупционер: коррупционеров
реформироваться: реформировались
улучшаться: улучшались
блистательный: блистательная
многоходовый: многоходовая
комбинация: комбинация
лёгкость: легкостью
одурачить: одурачила
усыпить: усыпленные
легенда: легендой
развал: развале
проспать: проспали
геополитический: геополитического
доминанта: доминанта
менделеев: менделеев менделеева
лишить: лишат лишён
периодический: периодической
удостоиться: удостоился
сванта: сванте
ларссон: ларссон
королевский: королевской
ошибочный: ошибочного
неудачный: неудачный
исключать: исключаю
вердикт: вердикта вердикт
таблица: таблица
достоверный: достоверные
пустой: пустых
заполнять: заполнять
химик: химикам химику
принятие: принятия
подытожить: подытожил
джереми: джереми
левинсон: левинсону
рынок: рынка
садовод: садовод садовода
юнеско: юнеско
разрушать: разрушающий
инспекция: инспекции
оптовый: оптового
неидеальный: неидеальную
чистота: чистоту
необычайный: необычайный
мультикультурализм: мультикультурализм
десятилетие: десятилетий
континент: континенты континент
сливаться: сливаются
брат: братья
расовый: расовых
мегаполис: мегаполисах
впечатление: впечатлениями
жаннет: жаннет
лаврина: лаврин
радостный: радостную
обретение: обретением
почётный: почётного
шашлычный: шашлычную
побаловать: побаловать
шашлык: шашлыка
щедрый: щедрыми
скидка: скидками
конкурс: конкурс
памятный: памятной
табличка: таблички
логотип: логотипом
склонность: склонность
госизмена: госизмене
честно: честно
править: править
пожизненно: пожизненно
измена: измене
несложный: несложным
подключиться: подключиться
доработка: доработке
видеоконтент: видеоконтент
звуковой: звуковые
оценивать: оценивать
десятибалльный: десятибалльной
сильно: сильно
тестирование: тестирование
госдеп: госдепа
дуров: дуров
точный: точном
слегка: слегка
приоткрыть: приоткрыли
таинственность: таинственности
оценить: оценить
мем: мемов
медведь: медведь медведю
исполнение: исполнении
газманов: газманова
иосиф: иосифа
кобзон: кобзона
любэ: любэ
эстрада: эстрады
альтернатива: альтернатива
миграция: миграцию
голубеть: голубей
свадьба: свадьбе свадьбу
бомбоубежище: бомбоубежище
сарасоты: сарасоты
джейкоб: джейкоб
жених: жениха
церемония: церемонии
небо: небо
взмыть: взмыла
стая: стая
нагло: нагло
штука: штук
мэгга: мэгги
продемонстрировать: продемонстрировали
расистский: расистский
расист: расисты расистов
голубь: голуби
наказать: накажет
истец: истец
заявитель: заявителя
компенсация: компенсация
моральный: морального
ущерб: ущерба
миссури: миссури
шахматы: шахматы шахматами
воплощение: воплощением
челябинск: челябинске
перенести: перенесли перенести
ветхий: ветхое
сигарета: сигарет
челябинский: челябинская
связать: связано
переехать: переехавшая переедем
полгода: полгода
непригодный: непригодной
табачный: табачная
лавка: лавка
ст: ст
фз: фз
убедить: убедить
снос: сносу
лето: летом
оповестить: оповестили
разориться: разорится
бочкарёв: бочкарёв
болельщица: болельщиц
выдвинуть: выдвинула выдвинуто
трансляция: трансляции
лицензия: лицензией
направлять: направлять
антидискриминационный: антидискриминационной
женский: женского
отгрузить: отгрузят
снабдить: снабдят
опросить: опросили
зарегистрироваться: зарегистрировались
равенство: равенство
современность: современность
интересоваться: интересуются
изъявить: изъявили
плакат: плакаты
слоган: слоганами
орудие: орудие
угнетение: угнетение
сенцов: сенцову
бодить: боди
позитив: позитив
предостерегать: предостерегают
трата: траты
промолчать: промолчите
завтра: завтра
стоять: стоять
дин: дина
каннингем: каннингем
восхититься: восхитился
постсоветский: постсоветского
англия: англии англия
полуфинал: полуфинале
настолько: настолько
вкусный: вкусный
сырьё: сырья
грустно: грустно
профукать: профукала
гостиница: гостиницу
подёртой: подёртой
лавочка: лавочке
сэр: сэр
глотка: глоток
спросить: спросил
незамысловатый: незамысловатый
посыл: посыл
гораздо: гораздо
незнакомец: незнакомец
чистый: чистом
академик: академик
лингвист: лингвист
красный: красный
флакон: флаконе
дух: духов
бояр: бояра бояру
крепость: крепость
хмелеть: хмелеешь
выпить: выпить
требоваться: требуется
сущий: сущие
копейка: копейки
бирмингем: бирмингеме
антидепрессант: антидепрессант антидепрессанта
домогаться: домогавшийся
манекен: манекен
курьёзный: курьёзный
краснодар: краснодара
зотов: зотова зотовой
карандаш: карандашей
кисть: кисти
пристальный: пристальный
мужской: мужской мужского
спешно: спешно
почувствовать: почувствовала
прикосновение: прикосновение
чужой: чужой
бедро: бедра
выдержать: выдержав
домогательство: домогательств
мастер: мастером
дзюдо: дзюдо
скрутить: скрутила
мужлан: мужлан
безнаказанно: безнаказанно
пялиться: пялиться
задница: задницу
обездвижить: обездвижила
мерзавец: мерзавца
сестра: сёстрам
амазонка: амазонкам
засилье: засилье
рожать: рожать
строить: строить
матриархат: матриархат
рекламный: рекламный
стеллаж: стеллажей
избежание: избежание
эскалация: эскалации
автомобиль: автомобиль
шахматный: шахматном шахматного шахматный
норильск: норильске
бурый: бурый
степан: степан степану
афанасьев: афанасьев
косолапый: косолапый
одержать: одержал
свести: свёл
вничью: вничью
звать: зову
стёпа: стёпа
афанасий: афанасии
увлекаться: увлекался
обыгрывать: обыгрывает
шахматист: шахматистов
красноярский: красноярского
домино: домино
дрессировщик: дрессировщик
топоров: топоров
гроссмейстер: гроссмейстера
вручить: вручена
ставрополь: ставрополя ставрополе
закладка: закладки закладок
выпасть: выпала
дно: дна
умвд: умвд
ставропольский: ставропольского
демонстрация: демонстрацию
отличие: отличие
галочка: галочки
побывать: побывали
задержание: задержаниях
допрос: допросах допроса
рейд: рейдах
квартира: квартирам
потенциально: потенциально
познавательный: познавательно
размышление: размышления
ждать: ждёт
увлекательный: увлекательна
координатор: координатор
майор: майор
степашкин: степашкин
краевой: краевого
добросовестно: добросовестно
преподаватель: преподаватели
пить: пить
финский: финских
днк: днк
родственный: родственные
беркович: берковича
происхождение: происхождение
генетик: генетик
перельманна: перельманн
санни: санни
гран: гран
лаасонный: лаасонен
распитие: распития
спиртной: спиртных
подробно: подробно
тысячелетие: тысячелетий
нынешний: нынешним
вступать: вступать
социализация: социализация
протекать: протекает
сгладить: сгладить
угол: углы
обиженный: обиженным
ученик: ученикам
закусывать: закусывать
окружающий: окружающими
достижение: достижению
совершеннолетие: совершеннолетия
спокойно: спокойно
пропустить: пропустить
бутылочка: бутылочки
запланировать: запланированы
петербургский: петербургский
алкоголизм: алкоголизма
попрактиковаться: попрактиковаться
опытный: опытными
карелия: карелии
алкотуризм: алкотуризма
подбрасывать: подбрасывали подбрасывала
кролик: кроликов
покидать: покидающим покидающих
киргиз: киргизы
атамбай: атамбай
желдайберген: желдайбергенов
сидней: сиднея
бригада: бригада
таронг: таронга
таможня: таможни
носильщик: носильщиков
вылетать: вылетающим
интерпол: интерполом интерполу
диверсия: диверсия
санкционировать: санкционирована
зоопитомник: зоопитомника
расти: растущей
популяция: популяцией
тайно: тайно
высылать: высылать
зверь: зверей
нелегал: нелегалов
лос: лос
анджелес: анджелеса
ушастый: ушастых
лондонский: лондонском
хитроу: хитроу
выявлять: выявлять
похитить: похищенный
гранить: гранённый
стакан: стакан
разделять: разделяю
бухгалтерский: бухгалтерскому
архип: архип
некрасов: некрасов
кузнец: кузнец
виновник: виновником
кража: кражи
раритетный: раритетного
экспонат: экспоната
подрабатывать: подрабатывавший
питание: питания
этаж: этаже
музейный: музейная
экспозиция: экспозиция
подменить: подменить
охранник: охранников
ночной: ночной
видеонаблюдение: видеонаблюдение
исчезнуть: исчез
подыскать: подыскать
недорогой: недорогие
часы: часы
элитный: элитных
лот: лот
стоимость: стоимостью
оговорить: оговоренной
продавец: продавцом
поличное: поличным
персональный: персональный
ёмкость: ёмкостью
владимирский: владимирского
стеклотара: стеклотары
агитационный: агитационной
инициал: инициалы
выгравировать: выгравированные
стенка: стенок
сосуд: сосуда
сорвать: сорвали
индеец: индейцев индейцы
хьюстон: хьюстоне
серебренник: серебренников
лепта: лепту
калашников: калашников
фсин: фсин
шествие: шествие
рапорт: рапорте
ратовать: ратующие
коренной: коренного
соединить: соединённых
атаковать: атакованы
агрессивный: агрессивной
избитый: избиты
кожаный: кожаными
плётка: плётками
транспарант: транспаранты
бросить: брошены
добродушно: добродушно
банан: бананами
угощать: угощали
шон: шон
коделли: коделли
маргинальный: маргинальная
тренд: тренде
приоритет: приоритете
отморозок: отморозков
финансировать: финансирует
отвлечь: отвлечь
замечать: замечать
краснопузый: краснопузые
туда: туда
морис: морис
